기준일,지역명,당일확진자,지역확진,해외확진,누적확진자
20210713,검역,19,0,19,4593
20210713,제주,21,21,0,1433
20210713,경남,89,87,2,5661
20210713,경북,22,19,3,5085
20210713,전남,6,6,0,1744
20210713,전북,9,9,0,2463
20210713,충남,36,36,0,4218
20210713,충북,10,9,1,3416
20210713,강원,16,15,1,3770
20210713,경기,465,453,12,48636
20210713,세종,6,6,0,617
20210713,울산,11,11,0,2959
20210713,대전,41,41,0,3046
20210713,광주,15,15,0,3062
20210713,인천,96,93,3,7495
20210713,대구,52,52,0,10850
20210713,부산,63,62,1,6810
20210713,서울,638,633,5,56053
20210713,합계,1615,1568,47,171911
20210712,검역,29,0,29,4574
20210712,제주,19,19,0,1412
20210712,경남,51,49,2,5572
20210712,경북,8,8,0,5063
20210712,전남,13,13,0,1738
20210712,전북,18,18,0,2454
20210712,충남,36,32,4,4182
20210712,충북,8,7,1,3406
20210712,강원,19,19,0,3754
20210712,경기,318,313,5,48171
20210712,세종,8,8,0,611
20210712,울산,7,7,0,2948
20210712,대전,31,31,0,3005
20210712,광주,9,9,0,3047
20210712,인천,71,67,4,7399
20210712,대구,38,36,2,10798
20210712,부산,50,47,3,6747
20210712,서울,417,414,3,55415
20210712,합계,1150,1097,53,170296
20210711,검역,20,0,20,4545
20210711,제주,7,7,0,1393
20210711,경남,40,40,0,5521
20210711,경북,13,12,1,5055
20210711,전남,19,19,0,1725
20210711,전북,4,4,0,2436
20210711,충남,45,43,2,4146
20210711,충북,14,13,1,3398
20210711,강원,18,18,0,3735
20210711,경기,327,322,5,47853
20210711,세종,6,6,0,603
20210711,울산,8,8,0,2941
20210711,대전,25,25,0,2974
20210711,광주,14,13,1,3038
20210711,인천,56,51,5,7328
20210711,대구,37,37,0,10760
20210711,부산,44,43,1,6697
20210711,서울,403,402,1,54998
20210711,합계,1100,1063,37,169146
20210710,검역,12,0,12,4525
20210710,제주,24,24,0,1386
20210710,경남,67,63,4,5481
20210710,경북,12,10,2,5042
20210710,전남,6,5,1,1706
20210710,전북,2,2,0,2432
20210710,충남,32,31,1,4101
20210710,충북,8,7,1,3384
20210710,강원,20,20,0,3717
20210710,경기,407,399,8,47526
20210710,세종,3,3,0,597
20210710,울산,22,22,0,2933
20210710,대전,32,31,1,2949
20210710,광주,23,22,1,3024
20210710,인천,66,64,2,7272
20210710,대구,23,23,0,10723
20210710,부산,56,53,3,6653
20210710,서울,509,501,8,54595
20210710,합계,1324,1280,44,168046
20210709,검역,21,0,21,4513
20210709,제주,10,10,0,1362
20210709,경남,36,36,0,5414
20210709,경북,13,9,4,5030
20210709,전남,2,2,0,1700
20210709,전북,14,14,0,2430
20210709,충남,29,28,1,4069
20210709,충북,19,18,1,3376
20210709,강원,16,15,1,3697
20210709,경기,451,441,10,47119
20210709,세종,0,0,0,594
20210709,울산,30,29,1,2911
20210709,대전,48,47,1,2917
20210709,광주,21,20,1,3001
20210709,인천,84,79,5,7206
20210709,대구,14,12,2,10700
20210709,부산,61,59,2,6597
20210709,서울,509,501,8,54086
20210709,합계,1378,1320,58,166722
20210708,검역,39,0,39,4492
20210708,제주,31,30,1,1352
20210708,경남,17,17,0,5378
20210708,경북,9,9,0,5017
20210708,전남,5,5,0,1698
20210708,전북,8,8,0,2416
20210708,충남,52,51,1,4040
20210708,충북,14,13,1,3357
20210708,강원,24,23,1,3681
20210708,경기,405,396,9,46668
20210708,세종,1,1,0,594
20210708,울산,16,16,0,2881
20210708,대전,29,28,1,2869
20210708,광주,4,3,1,2980
20210708,인천,82,72,10,7122
20210708,대구,19,16,3,10686
20210708,부산,58,53,5,6536
20210708,서울,503,495,8,53577
20210708,합계,1316,1236,80,165344
20210707,검역,25,0,25,4453
20210707,제주,17,17,0,1321
20210707,경남,10,7,3,5361
20210707,경북,4,4,0,5008
20210707,전남,9,7,2,1693
20210707,전북,3,3,0,2408
20210707,충남,78,77,1,3988
20210707,충북,8,8,0,3343
20210707,강원,16,15,1,3657
20210707,경기,392,388,4,46263
20210707,세종,5,4,1,593
20210707,울산,9,8,1,2865
20210707,대전,13,12,1,2840
20210707,광주,2,2,0,2976
20210707,인천,64,61,3,7040
20210707,대구,15,14,1,10667
20210707,부산,55,55,0,6478
20210707,서울,550,545,5,53074
20210707,합계,1275,1227,48,164028
20210706,검역,20,0,20,4428
20210706,제주,19,18,1,1304
20210706,경남,15,15,0,5351
20210706,경북,6,4,2,5004
20210706,전남,10,10,0,1684
20210706,전북,8,8,0,2405
20210706,충남,16,16,0,3910
20210706,충북,5,5,0,3335
20210706,강원,12,12,0,3641
20210706,경기,367,357,10,45871
20210706,세종,5,5,0,588
20210706,울산,1,1,0,2856
20210706,대전,30,29,1,2827
20210706,광주,11,10,1,2974
20210706,인천,57,56,1,6976
20210706,대구,13,12,1,10652
20210706,부산,34,33,1,6423
20210706,서울,583,577,6,52524
20210706,합계,1212,1168,44,162753
20210705,검역,30,0,30,4408
20210705,제주,5,4,1,1285
20210705,경남,19,17,2,5336
20210705,경북,11,11,0,4998
20210705,전남,4,4,0,1674
20210705,전북,6,6,0,2397
20210705,충남,13,11,2,3894
20210705,충북,2,2,0,3330
20210705,강원,9,6,3,3629
20210705,경기,229,224,5,45504
20210705,세종,5,5,0,583
20210705,울산,3,3,0,2855
20210705,대전,26,26,0,2797
20210705,광주,4,4,0,2963
20210705,인천,23,20,3,6919
20210705,대구,8,7,1,10639
20210705,부산,29,27,2,6389
20210705,서울,320,313,7,51941
20210705,합계,746,690,56,161541
20210704,검역,25,0,25,4378
20210704,제주,6,5,1,1280
20210704,경남,22,20,2,5317
20210704,경북,13,10,3,4987
20210704,전남,6,3,3,1670
20210704,전북,6,6,0,2391
20210704,충남,12,10,2,3881
20210704,충북,3,3,0,3328
20210704,강원,7,7,0,3620
20210704,경기,220,210,10,45275
20210704,세종,4,4,0,578
20210704,울산,1,1,0,2852
20210704,대전,19,18,1,2771
20210704,광주,7,6,1,2959
20210704,인천,22,16,6,6896
20210704,대구,6,4,2,10631
20210704,부산,25,20,5,6360
20210704,서울,307,301,6,51621
20210704,합계,711,644,67,160795
20210703,검역,50,0,50,4353
20210703,제주,2,2,0,1274
20210703,경남,15,14,1,5295
20210703,경북,9,8,1,4974
20210703,전남,0,0,0,1664
20210703,전북,3,2,1,2385
20210703,충남,7,7,0,3869
20210703,충북,2,2,0,3325
20210703,강원,19,11,8,3613
20210703,경기,231,227,4,45055
20210703,세종,4,4,0,574
20210703,울산,13,10,3,2851
20210703,대전,32,32,0,2752
20210703,광주,3,1,2,2952
20210703,인천,33,28,5,6874
20210703,대구,3,2,1,10625
20210703,부산,28,26,2,6335
20210703,서울,289,286,3,51314
20210703,합계,743,662,81,160084
20210702,검역,23,0,23,4303
20210702,제주,4,4,0,1272
20210702,경남,10,8,2,5280
20210702,경북,4,3,1,4965
20210702,전남,7,6,1,1664
20210702,전북,4,4,0,2382
20210702,충남,16,16,0,3862
20210702,충북,6,5,1,3323
20210702,강원,11,11,0,3594
20210702,경기,252,247,5,44824
20210702,세종,3,3,0,570
20210702,울산,1,0,1,2838
20210702,대전,28,28,0,2720
20210702,광주,3,3,0,2949
20210702,인천,16,14,2,6841
20210702,대구,8,8,0,10622
20210702,부산,39,35,4,6307
20210702,서울,359,353,6,51026
20210702,합계,794,748,46,159342
20210701,검역,33,0,33,4280
20210701,제주,3,3,0,1268
20210701,경남,13,12,1,5270
20210701,경북,7,7,0,4961
20210701,전남,4,4,0,1657
20210701,전북,7,7,0,2378
20210701,충남,27,27,0,3846
20210701,충북,7,7,0,3317
20210701,강원,14,7,7,3583
20210701,경기,264,260,4,44572
20210701,세종,2,2,0,567
20210701,울산,11,10,1,2837
20210701,대전,25,25,0,2692
20210701,광주,2,2,0,2946
20210701,인천,22,22,0,6825
20210701,대구,9,8,1,10614
20210701,부산,29,25,4,6268
20210701,서울,347,337,10,50667
20210701,합계,826,765,61,158548
20210630,검역,31,0,31,4247
20210630,제주,1,1,0,1265
20210630,경남,10,10,0,5257
20210630,경북,5,4,1,4954
20210630,전남,5,5,0,1653
20210630,전북,7,7,0,2371
20210630,충남,15,13,2,3819
20210630,충북,4,4,0,3310
20210630,강원,10,8,2,3569
20210630,경기,249,245,4,44308
20210630,세종,5,5,0,565
20210630,울산,2,1,1,2826
20210630,대전,16,16,0,2667
20210630,광주,7,7,0,2944
20210630,인천,36,30,6,6803
20210630,대구,7,7,0,10605
20210630,부산,18,17,1,6239
20210630,서울,333,331,2,50321
20210630,합계,761,711,50,157723
20210629,검역,17,0,17,4216
20210629,제주,2,2,0,1264
20210629,경남,17,16,1,5247
20210629,경북,4,3,1,4949
20210629,전남,7,7,0,1648
20210629,전북,10,10,0,2364
20210629,충남,8,8,0,3804
20210629,충북,5,5,0,3306
20210629,강원,15,14,1,3559
20210629,경기,240,234,6,44059
20210629,세종,3,3,0,560
20210629,울산,4,4,0,2824
20210629,대전,26,26,0,2651
20210629,광주,6,6,0,2937
20210629,인천,30,29,1,6767
20210629,대구,11,11,0,10598
20210629,부산,14,13,1,6221
20210629,서울,375,368,7,49987
20210629,합계,794,759,35,156961
20210628,검역,16,0,16,4199
20210628,제주,6,6,0,1262
20210628,경남,15,13,2,5230
20210628,경북,6,5,1,4945
20210628,전남,4,2,2,1641
20210628,전북,7,7,0,2354
20210628,충남,11,11,0,3796
20210628,충북,10,7,3,3301
20210628,강원,8,8,0,3544
20210628,경기,230,228,2,43819
20210628,세종,3,3,0,557
20210628,울산,13,13,0,2820
20210628,대전,25,25,0,2625
20210628,광주,2,2,0,2931
20210628,인천,17,17,0,6737
20210628,대구,8,6,2,10587
20210628,부산,9,6,3,6207
20210628,서울,205,201,4,49612
20210628,합계,595,560,35,156167
20210627,검역,11,0,11,4183
20210627,제주,2,2,0,1256
20210627,경남,10,10,0,5215
20210627,경북,1,1,0,4939
20210627,전남,2,2,0,1637
20210627,전북,2,2,0,2347
20210627,충남,8,6,2,3785
20210627,충북,5,5,0,3291
20210627,강원,17,16,1,3536
20210627,경기,162,157,5,43589
20210627,세종,0,0,0,554
20210627,울산,8,7,1,2807
20210627,대전,7,7,0,2600
20210627,광주,7,6,1,2929
20210627,인천,31,30,1,6720
20210627,대구,5,5,0,10579
20210627,부산,38,37,1,6198
20210627,서울,185,179,6,49407
20210627,합계,501,472,29,155572
20210626,검역,34,0,34,4172
20210626,제주,2,2,0,1254
20210626,경남,14,13,1,5205
20210626,경북,4,4,0,4938
20210626,전남,6,5,1,1635
20210626,전북,6,6,0,2345
20210626,충남,24,23,1,3777
20210626,충북,4,3,1,3286
20210626,강원,19,19,0,3519
20210626,경기,173,171,2,43427
20210626,세종,8,8,0,554
20210626,울산,6,3,3,2799
20210626,대전,15,15,0,2593
20210626,광주,12,12,0,2922
20210626,인천,25,24,1,6689
20210626,대구,8,8,0,10574
20210626,부산,12,12,0,6160
20210626,서울,242,242,0,49222
20210626,합계,614,570,44,155071
20210625,검역,31,0,31,4138
20210625,제주,9,9,0,1252
20210625,경남,12,12,0,5191
20210625,경북,9,9,0,4934
20210625,전남,3,3,0,1629
20210625,전북,5,3,2,2339
20210625,충남,7,6,1,3753
20210625,충북,5,5,0,3282
20210625,강원,35,23,12,3500
20210625,경기,188,185,3,43254
20210625,세종,2,2,0,546
20210625,울산,22,22,0,2793
20210625,대전,13,12,1,2578
20210625,광주,8,7,1,2910
20210625,인천,12,12,0,6664
20210625,대구,13,13,0,10566
20210625,부산,31,28,3,6148
20210625,서울,263,260,3,48980
20210625,합계,668,611,57,154457
20210624,검역,13,0,13,4107
20210624,제주,5,4,1,1243
20210624,경남,17,17,0,5179
20210624,경북,7,6,1,4925
20210624,전남,18,17,1,1626
20210624,전북,2,1,1,2334
20210624,충남,4,4,0,3746
20210624,충북,10,10,0,3277
20210624,강원,13,13,0,3465
20210624,경기,183,179,4,43066
20210624,세종,2,2,0,544
20210624,울산,16,16,0,2771
20210624,대전,9,8,1,2565
20210624,광주,5,5,0,2902
20210624,인천,29,24,5,6652
20210624,대구,5,5,0,10553
20210624,부산,27,27,0,6117
20210624,서울,269,264,5,48717
20210624,합계,634,602,32,153789
20210623,검역,19,0,19,4094
20210623,제주,4,3,1,1238
20210623,경남,23,22,1,5162
20210623,경북,29,28,1,4918
20210623,전남,6,3,3,1608
20210623,전북,6,6,0,2332
20210623,충남,7,7,0,3742
20210623,충북,6,5,1,3267
20210623,강원,5,5,0,3452
20210623,경기,185,184,1,42883
20210623,세종,1,1,0,542
20210623,울산,13,11,2,2755
20210623,대전,15,15,0,2556
20210623,광주,1,1,0,2897
20210623,인천,15,15,0,6623
20210623,대구,3,3,0,10548
20210623,부산,20,16,4,6090
20210623,서울,252,251,1,48448
20210623,합계,610,576,34,153155
20210622,검역,13,0,13,4075
20210622,제주,0,0,0,1234
20210622,경남,18,18,0,5139
20210622,경북,21,21,0,4889
20210622,전남,2,2,0,1602
20210622,전북,2,2,0,2326
20210622,충남,9,9,0,3735
20210622,충북,10,10,0,3261
20210622,강원,17,17,0,3447
20210622,경기,191,180,11,42698
20210622,세종,8,7,1,541
20210622,울산,5,5,0,2742
20210622,대전,58,57,1,2541
20210622,광주,4,4,0,2896
20210622,인천,28,26,2,6608
20210622,대구,7,6,1,10545
20210622,부산,16,13,3,6070
20210622,서울,236,228,8,48196
20210622,합계,645,605,40,152545
20210621,검역,29,0,29,4062
20210621,제주,1,1,0,1234
20210621,경남,11,11,0,5121
20210621,경북,11,10,1,4868
20210621,전남,8,6,2,1600
20210621,전북,2,2,0,2324
20210621,충남,12,11,1,3726
20210621,충북,16,16,0,3251
20210621,강원,10,10,0,3430
20210621,경기,92,92,0,42507
20210621,세종,6,6,0,533
20210621,울산,5,4,1,2737
20210621,대전,31,30,1,2483
20210621,광주,2,2,0,2892
20210621,인천,18,15,3,6580
20210621,대구,3,3,0,10538
20210621,부산,6,6,0,6054
20210621,서울,132,126,6,47960
20210621,합계,394,350,44,151900
20210620,검역,12,0,12,4033
20210620,제주,3,2,1,1233
20210620,경남,13,10,3,5110
20210620,경북,8,6,2,4857
20210620,전남,10,10,0,1592
20210620,전북,3,3,0,2322
20210620,충남,11,11,0,3714
20210620,충북,3,2,1,3235
20210620,강원,9,7,2,3420
20210620,경기,91,88,3,42415
20210620,세종,2,2,0,527
20210620,울산,0,0,0,2732
20210620,대전,15,14,1,2452
20210620,광주,2,1,1,2890
20210620,인천,9,7,2,6562
20210620,대구,18,16,2,10535
20210620,부산,14,11,3,6048
20210620,서울,134,127,7,47829
20210620,합계,357,317,40,151506
20210619,검역,19,0,19,4021
20210619,제주,2,2,0,1230
20210619,경남,11,10,1,5097
20210619,경북,6,5,1,4849
20210619,전남,3,3,0,1582
20210619,전북,3,3,0,2319
20210619,충남,10,10,0,3703
20210619,충북,6,6,0,3232
20210619,강원,13,13,0,3411
20210619,경기,113,111,2,42324
20210619,세종,3,2,1,525
20210619,울산,5,5,0,2732
20210619,대전,8,8,0,2437
20210619,광주,3,2,1,2888
20210619,인천,22,19,3,6553
20210619,대구,16,15,1,10517
20210619,부산,21,14,7,6034
20210619,서울,165,152,13,47695
20210619,합계,429,380,49,151149
20210618,검역,12,0,12,4002
20210618,제주,7,7,0,1228
20210618,경남,11,10,1,5086
20210618,경북,4,4,0,4843
20210618,전남,5,5,0,1579
20210618,전북,5,5,0,2316
20210618,충남,12,12,0,3693
20210618,충북,10,10,0,3226
20210618,강원,5,5,0,3398
20210618,경기,145,141,4,42211
20210618,세종,2,2,0,522
20210618,울산,5,5,0,2727
20210618,대전,5,5,0,2429
20210618,광주,4,4,0,2885
20210618,인천,22,20,2,6531
20210618,대구,13,13,0,10501
20210618,부산,18,15,3,6013
20210618,서울,197,193,4,47530
20210618,합계,482,456,26,150720
20210617,검역,10,0,10,3990
20210617,제주,6,6,0,1221
20210617,경남,14,12,2,5075
20210617,경북,11,10,1,4839
20210617,전남,4,4,0,1574
20210617,전북,4,3,1,2311
20210617,충남,7,7,0,3681
20210617,충북,19,19,0,3216
20210617,강원,9,9,0,3393
20210617,경기,153,151,2,42066
20210617,세종,1,1,0,520
20210617,울산,11,11,0,2722
20210617,대전,13,12,1,2424
20210617,광주,2,1,1,2881
20210617,인천,22,21,1,6509
20210617,대구,11,11,0,10488
20210617,부산,10,9,1,5995
20210617,서울,200,197,3,47333
20210617,합계,507,484,23,150238
20210616,검역,8,0,8,3980
20210616,제주,8,8,0,1215
20210616,경남,5,5,0,5061
20210616,경북,3,3,0,4828
20210616,전남,6,6,0,1570
20210616,전북,7,6,1,2307
20210616,충남,5,5,0,3674
20210616,충북,18,18,0,3197
20210616,강원,7,6,1,3384
20210616,경기,183,181,2,41913
20210616,세종,2,1,1,519
20210616,울산,22,22,0,2711
20210616,대전,18,18,0,2411
20210616,광주,6,6,0,2879
20210616,인천,17,17,0,6487
20210616,대구,7,7,0,10477
20210616,부산,17,15,2,5985
20210616,서울,201,199,2,47133
20210616,합계,540,523,17,149731
20210615,검역,8,0,8,3972
20210615,제주,9,9,0,1207
20210615,경남,7,7,0,5056
20210615,경북,3,3,0,4825
20210615,전남,8,8,0,1564
20210615,전북,2,2,0,2300
20210615,충남,8,7,1,3669
20210615,충북,17,17,0,3179
20210615,강원,7,7,0,3377
20210615,경기,190,184,6,41730
20210615,세종,4,4,0,517
20210615,울산,7,6,1,2689
20210615,대전,29,28,1,2393
20210615,광주,1,1,0,2873
20210615,인천,12,11,1,6470
20210615,대구,16,16,0,10470
20210615,부산,16,13,3,5968
20210615,서울,201,199,2,46932
20210615,합계,545,522,23,149191
20210614,검역,9,0,9,3964
20210614,제주,6,6,0,1198
20210614,경남,3,3,0,5049
20210614,경북,5,2,3,4822
20210614,전남,3,3,0,1556
20210614,전북,4,4,0,2298
20210614,충남,7,6,1,3661
20210614,충북,14,14,0,3162
20210614,강원,3,2,1,3370
20210614,경기,120,118,2,41540
20210614,세종,8,7,1,513
20210614,울산,4,4,0,2682
20210614,대전,15,14,1,2364
20210614,광주,4,3,1,2872
20210614,인천,12,11,1,6458
20210614,대구,16,16,0,10454
20210614,부산,9,6,3,5952
20210614,서울,131,127,4,46731
20210614,합계,373,346,27,148646
20210613,검역,16,0,16,3955
20210613,제주,9,9,0,1192
20210613,경남,13,13,0,5046
20210613,경북,4,4,0,4817
20210613,전남,4,4,0,1553
20210613,전북,2,2,0,2294
20210613,충남,7,7,0,3654
20210613,충북,23,23,0,3148
20210613,강원,11,10,1,3367
20210613,경기,122,113,9,41420
20210613,세종,1,0,1,505
20210613,울산,0,0,0,2678
20210613,대전,10,10,0,2349
20210613,광주,4,3,1,2868
20210613,인천,14,13,1,6446
20210613,대구,20,19,1,10438
20210613,부산,17,10,7,5943
20210613,서울,120,118,2,46598
20210613,합계,397,358,39,148271
20210612,검역,17,0,17,3939
20210612,제주,5,5,0,1183
20210612,경남,8,7,1,5033
20210612,경북,7,7,0,4813
20210612,전남,3,3,0,1549
20210612,전북,1,1,0,2292
20210612,충남,10,8,2,3647
20210612,충북,6,6,0,3125
20210612,강원,10,10,0,3356
20210612,경기,149,142,7,41298
20210612,세종,1,1,0,504
20210612,울산,2,2,0,2678
20210612,대전,11,11,0,2339
20210612,광주,3,2,1,2864
20210612,인천,15,13,2,6432
20210612,대구,15,14,1,10418
20210612,부산,13,13,0,5926
20210612,서울,174,172,2,46476
20210612,합계,450,417,33,147872
20210611,검역,9,0,9,3922
20210611,제주,5,5,0,1178
20210611,경남,25,23,2,5025
20210611,경북,5,5,0,4806
20210611,전남,4,4,0,1546
20210611,전북,2,2,0,2291
20210611,충남,5,4,1,3637
20210611,충북,12,12,0,3119
20210611,강원,11,10,1,3346
20210611,경기,174,170,4,41149
20210611,세종,1,0,1,503
20210611,울산,6,6,0,2676
20210611,대전,22,22,0,2328
20210611,광주,7,4,3,2861
20210611,인천,20,19,1,6417
20210611,대구,23,21,2,10403
20210611,부산,26,13,13,5913
20210611,서울,206,203,3,46300
20210611,합계,563,523,40,147420
20210610,검역,4,0,4,3913
20210610,제주,5,5,0,1173
20210610,경남,20,20,0,5000
20210610,경북,6,6,0,4801
20210610,전남,5,5,0,1542
20210610,전북,4,4,0,2289
20210610,충남,5,5,0,3632
20210610,충북,16,16,0,3107
20210610,강원,11,10,1,3335
20210610,경기,173,172,1,40975
20210610,세종,2,1,1,502
20210610,울산,15,15,0,2670
20210610,대전,15,15,0,2306
20210610,광주,1,1,0,2854
20210610,인천,18,17,1,6397
20210610,대구,24,23,1,10380
20210610,부산,28,25,3,5887
20210610,서울,202,199,3,46092
20210610,합계,554,539,15,146855
20210609,검역,8,0,8,3909
20210609,제주,10,10,0,1168
20210609,경남,33,33,0,4980
20210609,경북,11,9,2,4795
20210609,전남,4,4,0,1537
20210609,전북,2,2,0,2285
20210609,충남,7,7,0,3627
20210609,충북,24,24,0,3091
20210609,강원,16,16,0,3324
20210609,경기,180,176,4,40802
20210609,세종,3,3,0,500
20210609,울산,7,7,0,2655
20210609,대전,22,21,1,2291
20210609,광주,4,3,1,2853
20210609,인천,22,22,0,6379
20210609,대구,30,29,1,10356
20210609,부산,15,15,0,5859
20210609,서울,211,211,0,45890
20210609,합계,609,592,17,146301
20210608,검역,5,0,5,3901
20210608,제주,7,6,1,1158
20210608,경남,39,39,0,4947
20210608,경북,13,12,1,4784
20210608,전남,6,6,0,1533
20210608,전북,6,6,0,2283
20210608,충남,5,4,1,3620
20210608,충북,23,23,0,3067
20210608,강원,30,29,1,3308
20210608,경기,161,155,6,40622
20210608,세종,3,3,0,497
20210608,울산,6,6,0,2648
20210608,대전,25,25,0,2269
20210608,광주,7,7,0,2849
20210608,인천,23,21,2,6357
20210608,대구,44,44,0,10326
20210608,부산,16,14,2,5844
20210608,서울,181,179,2,45677
20210608,합계,600,579,21,145690
20210607,검역,8,0,8,3896
20210607,제주,8,7,1,1151
20210607,경남,48,48,0,4908
20210607,경북,7,6,1,4771
20210607,전남,8,8,0,1527
20210607,전북,4,3,1,2277
20210607,충남,4,3,1,3615
20210607,충북,6,6,0,3044
20210607,강원,5,5,0,3278
20210607,경기,130,125,5,40461
20210607,세종,0,0,0,494
20210607,울산,3,3,0,2642
20210607,대전,22,22,0,2244
20210607,광주,1,1,0,2842
20210607,인천,13,11,2,6334
20210607,대구,33,33,0,10282
20210607,부산,15,15,0,5828
20210607,서울,138,138,0,45495
20210607,합계,452,434,18,145089
20210606,검역,10,0,10,3888
20210606,제주,13,13,0,1143
20210606,경남,28,27,1,4860
20210606,경북,9,8,1,4764
20210606,전남,3,3,0,1519
20210606,전북,3,3,0,2273
20210606,충남,9,9,0,3611
20210606,충북,11,10,1,3038
20210606,강원,2,2,0,3273
20210606,경기,151,146,5,40331
20210606,세종,0,0,0,494
20210606,울산,10,10,0,2639
20210606,대전,20,20,0,2222
20210606,광주,4,4,0,2841
20210606,인천,15,15,0,6321
20210606,대구,26,26,0,10249
20210606,부산,12,9,3,5813
20210606,서울,158,148,10,45356
20210606,합계,484,453,31,144635
20210605,검역,5,0,5,3878
20210605,제주,19,17,2,1130
20210605,경남,17,17,0,4832
20210605,경북,10,9,1,4755
20210605,전남,9,9,0,1516
20210605,전북,0,0,0,2270
20210605,충남,13,13,0,3602
20210605,충북,17,17,0,3027
20210605,강원,10,10,0,3271
20210605,경기,160,157,3,40180
20210605,세종,0,0,0,494
20210605,울산,7,7,0,2629
20210605,대전,18,18,0,2202
20210605,광주,2,2,0,2837
20210605,인천,23,22,1,6306
20210605,대구,46,45,1,10223
20210605,부산,21,21,0,5801
20210605,서울,178,176,2,45197
20210605,합계,555,540,15,144150
20210604,검역,5,0,5,3873
20210604,제주,22,22,0,1111
20210604,경남,20,20,0,4815
20210604,경북,10,10,0,4745
20210604,전남,14,14,0,1507
20210604,전북,14,13,1,2270
20210604,충남,10,9,1,3589
20210604,충북,24,24,0,3010
20210604,강원,14,14,0,3261
20210604,경기,211,206,5,40020
20210604,세종,4,4,0,494
20210604,울산,5,5,0,2622
20210604,대전,31,31,0,2184
20210604,광주,9,9,0,2835
20210604,인천,16,16,0,6283
20210604,대구,41,41,0,10177
20210604,부산,17,13,4,5780
20210604,서울,276,273,3,45018
20210604,합계,743,724,19,143594
20210603,검역,8,0,8,3868
20210603,제주,21,21,0,1089
20210603,경남,44,43,1,4795
20210603,경북,11,8,3,4735
20210603,전남,12,12,0,1493
20210603,전북,3,3,0,2256
20210603,충남,9,9,0,3579
20210603,충북,22,21,1,2986
20210603,강원,18,18,0,3247
20210603,경기,209,204,5,39809
20210603,세종,3,3,0,490
20210603,울산,15,14,1,2617
20210603,대전,18,18,0,2153
20210603,광주,7,7,0,2826
20210603,인천,10,10,0,6267
20210603,대구,65,65,0,10136
20210603,부산,14,13,1,5763
20210603,서울,205,204,1,44741
20210603,합계,694,673,21,142850
20210602,검역,3,0,3,3860
20210602,제주,12,12,0,1068
20210602,경남,23,23,0,4751
20210602,경북,11,11,0,4724
20210602,전남,3,3,0,1481
20210602,전북,12,12,0,2253
20210602,충남,13,13,0,3570
20210602,충북,5,5,0,2964
20210602,강원,17,16,1,3229
20210602,경기,211,207,4,39600
20210602,세종,1,1,0,487
20210602,울산,8,8,0,2602
20210602,대전,15,15,0,2135
20210602,광주,4,4,0,2819
20210602,인천,22,22,0,6257
20210602,대구,74,73,1,10071
20210602,부산,32,32,0,5749
20210602,서울,214,214,0,44535
20210602,합계,680,671,9,142155
20210601,검역,9,0,9,3857
20210601,제주,14,14,0,1056
20210601,경남,21,19,2,4728
20210601,경북,12,9,3,4713
20210601,전남,10,10,0,1478
20210601,전북,10,10,0,2241
20210601,충남,7,7,0,3557
20210601,충북,5,5,0,2959
20210601,강원,14,14,0,3212
20210601,경기,192,188,4,39389
20210601,세종,3,3,0,486
20210601,울산,14,14,0,2594
20210601,대전,23,23,0,2120
20210601,광주,5,5,0,2815
20210601,인천,20,19,1,6235
20210601,대구,39,39,0,9997
20210601,부산,21,19,2,5717
20210601,서울,257,255,2,44320
20210601,합계,676,653,23,141474
20210531,검역,4,0,4,3848
20210531,제주,12,12,0,1042
20210531,경남,8,8,0,4707
20210531,경북,9,9,0,4701
20210531,전남,5,5,0,1468
20210531,전북,6,6,0,2231
20210531,충남,12,11,1,3550
20210531,충북,11,11,0,2954
20210531,강원,13,13,0,3198
20210531,경기,116,116,0,39197
20210531,세종,3,3,0,483
20210531,울산,2,2,0,2580
20210531,대전,19,19,0,2097
20210531,광주,5,5,0,2810
20210531,인천,17,16,1,6215
20210531,대구,42,39,3,9958
20210531,부산,28,28,0,5696
20210531,서울,146,145,1,44062
20210531,합계,458,448,10,140797
20210530,검역,7,0,7,3844
20210530,제주,7,6,1,1030
20210530,경남,16,15,1,4699
20210530,경북,18,15,3,4692
20210530,전남,6,6,0,1463
20210530,전북,9,9,0,2225
20210530,충남,4,4,0,3538
20210530,충북,7,7,0,2943
20210530,강원,11,11,0,3185
20210530,경기,130,127,3,39081
20210530,세종,3,3,0,480
20210530,울산,3,3,0,2578
20210530,대전,6,6,0,2078
20210530,광주,13,13,0,2805
20210530,인천,12,10,2,6198
20210530,대구,31,31,0,9916
20210530,부산,17,16,1,5668
20210530,서울,129,128,1,43915
20210530,합계,429,410,19,140338
20210529,검역,7,0,7,3837
20210529,제주,8,8,0,1023
20210529,경남,10,9,1,4683
20210529,경북,9,9,0,4674
20210529,전남,9,9,0,1457
20210529,전북,7,7,0,2216
20210529,충남,7,5,2,3534
20210529,충북,6,6,0,2936
20210529,강원,17,17,0,3174
20210529,경기,160,156,4,38951
20210529,세종,6,6,0,477
20210529,울산,7,6,1,2575
20210529,대전,7,7,0,2072
20210529,광주,9,9,0,2792
20210529,인천,18,18,0,6186
20210529,대구,20,20,0,9885
20210529,부산,13,13,0,5651
20210529,서울,159,158,1,43785
20210529,합계,479,463,16,139908
20210528,검역,16,0,16,3830
20210528,제주,13,12,1,1015
20210528,경남,20,19,1,4673
20210528,경북,13,13,0,4665
20210528,전남,5,5,0,1448
20210528,전북,6,6,0,2209
20210528,충남,12,10,2,3527
20210528,충북,22,22,0,2930
20210528,강원,10,10,0,3157
20210528,경기,139,136,3,38791
20210528,세종,1,1,0,471
20210528,울산,8,8,0,2568
20210528,대전,11,11,0,2065
20210528,광주,9,9,0,2783
20210528,인천,18,17,1,6168
20210528,대구,22,22,0,9865
20210528,부산,14,14,0,5638
20210528,서울,193,189,4,43625
20210528,합계,532,504,28,139428
20210527,검역,11,0,11,3814
20210527,제주,7,7,0,1002
20210527,경남,21,21,0,4653
20210527,경북,14,14,0,4652
20210527,전남,7,7,0,1443
20210527,전북,4,4,0,2203
20210527,충남,21,21,0,3515
20210527,충북,14,14,0,2908
20210527,강원,16,16,0,3147
20210527,경기,149,146,3,38652
20210527,세종,8,8,0,470
20210527,울산,12,12,0,2560
20210527,대전,18,18,0,2054
20210527,광주,8,8,0,2774
20210527,인천,26,26,0,6150
20210527,대구,24,24,0,9843
20210527,부산,13,13,0,5624
20210527,서울,213,211,2,43431
20210527,합계,586,570,16,138895
20210526,검역,3,0,3,3803
20210526,제주,26,26,0,995
20210526,경남,18,18,0,4632
20210526,경북,12,10,2,4638
20210526,전남,16,16,0,1436
20210526,전북,6,6,0,2199
20210526,충남,17,17,0,3494
20210526,충북,9,9,0,2894
20210526,강원,7,7,0,3131
20210526,경기,170,168,2,38503
20210526,세종,8,8,0,462
20210526,울산,6,6,0,2548
20210526,대전,23,23,0,2036
20210526,광주,15,15,0,2766
20210526,인천,30,30,0,6124
20210526,대구,27,27,0,9819
20210526,부산,18,18,0,5611
20210526,서울,217,215,2,43217
20210526,합계,628,619,9,138308
20210525,검역,13,0,13,3800
20210525,제주,6,6,0,969
20210525,경남,20,20,0,4614
20210525,경북,9,9,0,4626
20210525,전남,11,11,0,1420
20210525,전북,6,6,0,2193
20210525,충남,19,19,0,3477
20210525,충북,13,13,0,2885
20210525,강원,25,25,0,3124
20210525,경기,190,184,7,38333
20210525,세종,9,9,0,454
20210525,울산,15,15,0,2542
20210525,대전,17,17,0,2013
20210525,광주,21,20,1,2751
20210525,인천,19,19,0,6094
20210525,대구,30,30,0,9792
20210525,부산,22,21,1,5593
20210525,서울,260,258,2,42999
20210525,합계,700,682,22,137679
20210524,검역,22,0,22,3787
20210524,제주,17,17,0,963
20210524,경남,14,13,1,4594
20210524,경북,12,11,1,4617
20210524,전남,7,7,0,1409
20210524,전북,5,5,0,2187
20210524,충남,22,20,2,3458
20210524,충북,9,8,1,2872
20210524,강원,21,20,1,3099
20210524,경기,136,132,4,38144
20210524,세종,14,14,0,445
20210524,울산,7,7,0,2527
20210524,대전,15,15,0,1996
20210524,광주,21,21,0,2730
20210524,인천,11,11,0,6075
20210524,대구,29,27,2,9762
20210524,부산,16,16,0,5571
20210524,서울,137,136,1,42738
20210524,합계,515,480,35,136974
20210523,검역,11,0,11,3765
20210523,제주,19,19,0,946
20210523,경남,17,17,0,4580
20210523,경북,12,12,0,4605
20210523,전남,14,12,2,1402
20210523,전북,4,4,0,2182
20210523,충남,31,28,3,3436
20210523,충북,7,7,0,2863
20210523,강원,20,18,2,3078
20210523,경기,122,120,2,38008
20210523,세종,14,14,0,431
20210523,울산,12,12,0,2520
20210523,대전,11,11,0,1981
20210523,광주,16,15,1,2709
20210523,인천,18,18,0,6064
20210523,대구,48,48,0,9733
20210523,부산,15,14,1,5555
20210523,서울,138,135,3,42600
20210523,합계,529,504,25,136458
20210522,검역,10,0,10,3754
20210522,제주,8,8,0,927
20210522,경남,17,17,0,4563
20210522,경북,12,12,0,4593
20210522,전남,10,10,0,1388
20210522,전북,14,14,0,2178
20210522,충남,24,24,0,3405
20210522,충북,9,9,0,2856
20210522,강원,19,18,1,3058
20210522,경기,151,150,1,37886
20210522,세종,1,1,0,417
20210522,울산,24,23,1,2508
20210522,대전,12,12,0,1970
20210522,광주,9,9,0,2693
20210522,인천,12,12,0,6046
20210522,대구,57,57,0,9685
20210522,부산,15,14,1,5540
20210522,서울,180,179,1,42461
20210522,합계,584,569,15,135928
20210521,검역,21,0,21,3744
20210521,제주,7,7,0,919
20210521,경남,21,21,0,4546
20210521,경북,16,15,1,4581
20210521,전남,16,16,0,1378
20210521,전북,12,12,0,2164
20210521,충남,17,17,0,3381
20210521,충북,6,4,2,2847
20210521,강원,29,29,0,3039
20210521,경기,165,163,2,37735
20210521,세종,0,0,0,416
20210521,울산,29,29,0,2484
20210521,대전,5,5,0,1958
20210521,광주,15,15,0,2684
20210521,인천,15,13,2,6034
20210521,대구,56,55,1,9628
20210521,부산,28,27,1,5525
20210521,서울,207,204,3,42280
20210521,합계,665,632,33,135343
20210520,검역,10,0,10,3723
20210520,제주,5,5,0,912
20210520,경남,18,18,0,4525
20210520,경북,11,11,0,4565
20210520,전남,17,17,0,1362
20210520,전북,16,15,1,2152
20210520,충남,41,40,1,3364
20210520,충북,12,12,0,2841
20210520,강원,7,7,0,3010
20210520,경기,164,161,3,37570
20210520,세종,1,1,0,416
20210520,울산,13,13,0,2455
20210520,대전,15,15,0,1953
20210520,광주,13,13,0,2669
20210520,인천,12,12,0,6019
20210520,대구,19,18,1,9572
20210520,부산,15,13,2,5497
20210520,서울,171,170,1,42072
20210520,합계,560,541,19,134677
20210519,검역,16,0,16,3713
20210519,제주,6,6,0,907
20210519,경남,12,12,0,4507
20210519,경북,33,33,0,4554
20210519,전남,7,6,1,1345
20210519,전북,7,7,0,2136
20210519,충남,19,19,0,3323
20210519,충북,13,13,0,2829
20210519,강원,8,8,0,3003
20210519,경기,187,183,4,37406
20210519,세종,9,8,1,415
20210519,울산,25,25,0,2442
20210519,대전,8,7,1,1938
20210519,광주,15,15,0,2656
20210519,인천,13,13,0,6007
20210519,대구,9,9,0,9553
20210519,부산,17,17,0,5482
20210519,서울,241,237,4,41900
20210519,합계,645,618,27,134116
20210518,검역,7,0,7,3697
20210518,제주,4,4,0,901
20210518,경남,16,16,0,4495
20210518,경북,24,24,0,4521
20210518,전남,10,10,0,1338
20210518,전북,9,9,0,2129
20210518,충남,17,16,1,3304
20210518,충북,21,21,0,2816
20210518,강원,16,16,0,2995
20210518,경기,164,159,5,37219
20210518,세종,3,3,0,406
20210518,울산,27,27,0,2417
20210518,대전,10,10,0,1930
20210518,광주,4,4,0,2641
20210518,인천,23,23,0,5994
20210518,대구,23,23,0,9544
20210518,부산,27,27,0,5465
20210518,서울,248,244,4,41658
20210518,합계,653,636,17,133470
20210517,검역,12,0,12,3690
20210517,제주,11,10,1,897
20210517,경남,16,15,1,4479
20210517,경북,23,21,2,4497
20210517,전남,12,12,0,1328
20210517,전북,7,7,0,2120
20210517,충남,15,15,0,3287
20210517,충북,13,13,0,2795
20210517,강원,25,25,0,2979
20210517,경기,137,134,3,37056
20210517,세종,4,4,0,403
20210517,울산,6,6,0,2390
20210517,대전,12,12,0,1920
20210517,광주,11,11,0,2637
20210517,인천,16,16,0,5971
20210517,대구,23,23,0,9521
20210517,부산,13,13,0,5438
20210517,서울,171,168,3,41409
20210517,합계,527,505,22,132817
20210516,검역,9,0,9,3678
20210516,제주,15,15,0,886
20210516,경남,30,30,0,4463
20210516,경북,27,27,0,4474
20210516,전남,20,17,3,1316
20210516,전북,9,9,0,2113
20210516,충남,16,14,2,3272
20210516,충북,23,22,1,2782
20210516,강원,35,35,0,2954
20210516,경기,150,148,2,36919
20210516,세종,0,0,0,399
20210516,울산,16,16,0,2384
20210516,대전,2,2,0,1908
20210516,광주,27,27,0,2626
20210516,인천,14,12,2,5955
20210516,대구,19,19,0,9498
20210516,부산,12,12,0,5425
20210516,서울,194,191,3,41237
20210516,합계,618,596,22,132289
20210515,검역,20,0,20,3669
20210515,제주,9,9,0,871
20210515,경남,45,44,1,4433
20210515,경북,11,11,0,4447
20210515,전남,13,13,0,1296
20210515,전북,14,13,1,2104
20210515,충남,18,14,4,3256
20210515,충북,20,19,1,2759
20210515,강원,5,5,0,2919
20210515,경기,161,156,5,36769
20210515,세종,0,0,0,399
20210515,울산,11,11,0,2368
20210515,대전,4,4,0,1906
20210515,광주,14,14,0,2599
20210515,인천,15,15,0,5941
20210515,대구,6,6,0,9479
20210515,부산,31,30,1,5413
20210515,서울,212,207,5,41042
20210515,합계,609,571,38,131670
20210514,검역,9,0,9,3649
20210514,제주,14,14,0,862
20210514,경남,40,38,2,4388
20210514,경북,19,19,0,4436
20210514,전남,26,26,0,1283
20210514,전북,11,10,1,2090
20210514,충남,12,10,2,3238
20210514,충북,5,5,0,2739
20210514,강원,12,12,0,2914
20210514,경기,170,168,2,36608
20210514,세종,3,3,0,399
20210514,울산,22,22,0,2357
20210514,대전,10,10,0,1902
20210514,광주,11,10,1,2585
20210514,인천,16,16,0,5926
20210514,대구,5,4,1,9473
20210514,부산,42,41,1,5382
20210514,서울,253,252,1,40829
20210514,합계,680,660,20,131060
20210513,검역,9,0,9,3640
20210513,제주,10,10,0,848
20210513,경남,32,28,4,4348
20210513,경북,35,34,1,4417
20210513,전남,50,50,0,1257
20210513,전북,14,14,0,2079
20210513,충남,22,22,0,3226
20210513,충북,4,4,0,2734
20210513,강원,25,25,0,2902
20210513,경기,173,172,1,36438
20210513,세종,7,7,0,396
20210513,울산,26,26,0,2335
20210513,대전,31,31,0,1892
20210513,광주,11,10,1,2574
20210513,인천,34,34,0,5910
20210513,대구,9,9,0,9468
20210513,부산,24,24,0,5340
20210513,서울,230,228,2,40575
20210513,합계,746,728,18,130379
20210512,검역,14,0,14,3631
20210512,제주,9,9,0,838
20210512,경남,32,30,2,4316
20210512,경북,23,22,1,4382
20210512,전남,12,12,0,1207
20210512,전북,10,10,0,2065
20210512,충남,19,19,0,3204
20210512,충북,10,10,0,2730
20210512,강원,17,15,2,2877
20210512,경기,226,222,4,36265
20210512,세종,2,2,0,389
20210512,울산,31,31,0,2309
20210512,대전,18,18,0,1861
20210512,광주,23,23,0,2563
20210512,인천,17,17,0,5876
20210512,대구,5,5,0,9459
20210512,부산,20,20,0,5316
20210512,서울,226,226,0,40344
20210512,합계,714,691,23,129632
20210511,검역,13,0,13,3617
20210511,제주,13,13,0,829
20210511,경남,16,15,1,4284
20210511,경북,7,7,0,4359
20210511,전남,17,17,0,1195
20210511,전북,22,22,0,2055
20210511,충남,10,10,0,3185
20210511,충북,12,12,0,2720
20210511,강원,17,16,1,2860
20210511,경기,187,184,3,36039
20210511,세종,1,1,0,387
20210511,울산,31,31,0,2278
20210511,대전,8,8,0,1843
20210511,광주,22,22,0,2540
20210511,인천,20,20,0,5859
20210511,대구,6,5,1,9454
20210511,부산,10,10,0,5296
20210511,서울,222,219,3,40117
20210511,합계,634,612,22,128917
20210510,검역,12,0,12,3604
20210510,제주,24,23,1,816
20210510,경남,10,9,1,4268
20210510,경북,15,15,0,4352
20210510,전남,10,10,0,1178
20210510,전북,12,12,0,2033
20210510,충남,18,18,0,3175
20210510,충북,4,4,0,2708
20210510,강원,12,12,0,2843
20210510,경기,137,127,10,35851
20210510,세종,0,0,0,386
20210510,울산,19,19,0,2247
20210510,대전,7,7,0,1835
20210510,광주,24,23,1,2518
20210510,인천,21,20,1,5839
20210510,대구,8,8,0,9448
20210510,부산,14,13,1,5286
20210510,서울,162,162,0,39894
20210510,합계,509,482,27,128281
20210509,검역,13,0,13,3592
20210509,제주,14,14,0,792
20210509,경남,16,14,2,4258
20210509,경북,19,19,0,4337
20210509,전남,9,9,0,1168
20210509,전북,9,9,0,2021
20210509,충남,15,14,1,3157
20210509,충북,4,4,0,2704
20210509,강원,5,4,1,2831
20210509,경기,137,135,2,35714
20210509,세종,7,7,0,386
20210509,울산,24,24,0,2228
20210509,대전,4,4,0,1828
20210509,광주,9,9,0,2494
20210509,인천,13,12,1,5818
20210509,대구,4,3,1,9440
20210509,부산,20,19,1,5272
20210509,서울,141,136,5,39732
20210509,합계,463,436,27,127772
20210508,검역,31,0,31,3579
20210508,제주,18,17,1,778
20210508,경남,30,30,0,4242
20210508,경북,19,19,0,4318
20210508,전남,24,24,0,1159
20210508,전북,8,8,0,2012
20210508,충남,10,10,0,3142
20210508,충북,9,8,1,2700
20210508,강원,7,7,0,2826
20210508,경기,149,144,5,35577
20210508,세종,1,1,0,379
20210508,울산,28,28,0,2204
20210508,대전,2,2,0,1824
20210508,광주,6,6,0,2485
20210508,인천,11,11,0,5805
20210508,대구,6,6,0,9436
20210508,부산,10,10,0,5252
20210508,서울,195,191,4,39591
20210508,합계,564,522,42,127309
20210507,검역,17,0,17,3548
20210507,제주,5,5,0,760
20210507,경남,37,37,0,4212
20210507,경북,21,20,1,4299
20210507,전남,12,11,1,1135
20210507,전북,5,4,1,2004
20210507,충남,3,3,0,3132
20210507,충북,9,9,0,2691
20210507,강원,27,27,0,2819
20210507,경기,194,192,2,35428
20210507,세종,5,5,0,378
20210507,울산,48,47,1,2176
20210507,대전,9,8,1,1822
20210507,광주,5,5,0,2479
20210507,인천,22,20,2,5794
20210507,대구,13,13,0,9430
20210507,부산,27,26,1,5242
20210507,서울,242,240,2,39396
20210507,합계,701,672,29,126745
20210506,검역,4,0,4,3531
20210506,제주,12,12,0,755
20210506,경남,32,30,2,4175
20210506,경북,12,12,0,4278
20210506,전남,12,12,0,1123
20210506,전북,6,6,0,1999
20210506,충남,9,8,1,3129
20210506,충북,5,4,1,2682
20210506,강원,8,8,0,2792
20210506,경기,139,136,3,35234
20210506,세종,0,0,0,373
20210506,울산,35,35,0,2128
20210506,대전,7,7,0,1813
20210506,광주,21,21,0,2474
20210506,인천,14,12,2,5772
20210506,대구,9,9,0,9417
20210506,부산,21,20,1,5215
20210506,서울,179,177,2,39154
20210506,합계,525,509,16,126044
20210505,검역,8,0,8,3527
20210505,제주,6,6,0,743
20210505,경남,17,17,0,4143
20210505,경북,22,21,1,4266
20210505,전남,10,10,0,1111
20210505,전북,5,5,0,1993
20210505,충남,15,13,2,3120
20210505,충북,6,6,0,2677
20210505,강원,12,12,0,2784
20210505,경기,142,142,0,35095
20210505,세종,1,1,0,373
20210505,울산,38,38,0,2093
20210505,대전,18,18,0,1806
20210505,광주,8,8,0,2453
20210505,인천,19,19,0,5758
20210505,대구,7,7,0,9408
20210505,부산,28,28,0,5194
20210505,서울,212,211,1,38975
20210505,합계,574,562,12,125519
20210504,검역,12,0,12,3519
20210504,제주,13,13,0,737
20210504,경남,27,26,1,4126
20210504,경북,38,38,0,4244
20210504,전남,12,12,0,1101
20210504,전북,6,6,0,1988
20210504,충남,10,10,0,3105
20210504,충북,11,11,0,2671
20210504,강원,48,48,0,2772
20210504,경기,168,161,7,34953
20210504,세종,0,0,0,372
20210504,울산,22,21,1,2055
20210504,대전,18,18,0,1788
20210504,광주,8,8,0,2445
20210504,인천,16,16,0,5739
20210504,대구,6,6,0,9401
20210504,부산,23,22,1,5166
20210504,서울,238,234,4,38763
20210504,합계,676,651,25,124945
20210503,검역,7,0,7,3507
20210503,제주,8,8,0,724
20210503,경남,36,35,1,4099
20210503,경북,22,18,4,4206
20210503,전남,9,9,0,1089
20210503,전북,12,12,0,1982
20210503,충남,19,18,1,3095
20210503,충북,7,5,2,2660
20210503,강원,22,22,0,2724
20210503,경기,124,117,7,34785
20210503,세종,6,5,1,372
20210503,울산,29,29,0,2033
20210503,대전,13,13,0,1770
20210503,광주,4,4,0,2437
20210503,인천,13,12,1,5723
20210503,대구,10,9,1,9395
20210503,부산,16,16,0,5143
20210503,서울,184,182,2,38525
20210503,합계,541,514,27,124269
20210502,검역,11,0,11,3500
20210502,제주,1,0,1,716
20210502,경남,44,44,0,4063
20210502,경북,32,31,1,4184
20210502,전남,24,24,0,1080
20210502,전북,12,12,0,1970
20210502,충남,10,10,0,3076
20210502,충북,9,9,0,2653
20210502,강원,10,9,1,2702
20210502,경기,130,129,1,34661
20210502,세종,4,3,1,366
20210502,울산,21,21,0,2004
20210502,대전,5,5,0,1757
20210502,광주,5,5,0,2433
20210502,인천,15,14,1,5710
20210502,대구,12,10,2,9385
20210502,부산,16,16,0,5127
20210502,서울,127,123,4,38341
20210502,합계,488,465,23,123728
20210501,검역,6,0,6,3489
20210501,제주,1,0,1,715
20210501,경남,61,61,0,4019
20210501,경북,30,30,0,4152
20210501,전남,1,1,0,1056
20210501,전북,12,12,0,1958
20210501,충남,16,16,0,3066
20210501,충북,11,10,1,2644
20210501,강원,4,4,0,2692
20210501,경기,145,140,5,34531
20210501,세종,1,1,0,362
20210501,울산,52,52,0,1983
20210501,대전,9,8,1,1752
20210501,광주,15,15,0,2428
20210501,인천,17,17,0,5695
20210501,대구,10,10,0,9373
20210501,부산,33,31,2,5111
20210501,서울,182,177,5,38214
20210501,합계,606,585,21,123240
20210430,검역,15,0,15,3483
20210430,제주,7,7,0,714
20210430,경남,43,41,2,3958
20210430,경북,12,11,1,4122
20210430,전남,2,2,0,1055
20210430,전북,10,9,1,1946
20210430,충남,17,16,1,3050
20210430,충북,5,4,1,2633
20210430,강원,4,4,0,2688
20210430,경기,190,187,3,34386
20210430,세종,4,4,0,361
20210430,울산,52,52,0,1931
20210430,대전,13,12,1,1743
20210430,광주,4,4,0,2413
20210430,인천,13,13,0,5678
20210430,대구,12,12,0,9363
20210430,부산,29,28,1,5078
20210430,서울,195,187,8,38032
20210430,합계,627,593,34,122634
20210429,검역,5,0,5,3468
20210429,제주,1,0,1,707
20210429,경남,37,37,0,3915
20210429,경북,29,28,1,4110
20210429,전남,5,5,0,1053
20210429,전북,21,21,0,1936
20210429,충남,12,12,0,3033
20210429,충북,12,11,1,2628
20210429,강원,4,4,0,2684
20210429,경기,151,148,3,34196
20210429,세종,1,1,0,357
20210429,울산,61,61,0,1879
20210429,대전,31,30,1,1730
20210429,광주,4,4,0,2409
20210429,인천,14,14,0,5665
20210429,대구,14,13,1,9351
20210429,부산,32,31,1,5049
20210429,서울,227,222,5,37837
20210429,합계,661,642,19,122007
20210428,검역,11,0,11,3463
20210428,제주,1,1,0,706
20210428,경남,38,38,0,3878
20210428,경북,25,24,2,4081
20210428,전남,2,0,2,1048
20210428,전북,9,9,0,1915
20210428,충남,16,15,1,3021
20210428,충북,10,10,0,2616
20210428,강원,13,12,1,2680
20210428,경기,182,176,6,34045
20210428,세종,0,0,0,356
20210428,울산,46,46,0,1818
20210428,대전,4,4,0,1699
20210428,광주,8,8,0,2405
20210428,인천,25,22,3,5651
20210428,대구,19,18,1,9337
20210428,부산,40,39,1,5017
20210428,서울,227,225,2,37610
20210428,합계,679,649,30,121346
20210427,검역,7,0,7,3452
20210427,제주,3,3,0,705
20210427,경남,55,55,0,3840
20210427,경북,25,23,2,4053
20210427,전남,5,5,0,1046
20210427,전북,13,13,0,1906
20210427,충남,38,38,0,3005
20210427,충북,22,22,0,2606
20210427,강원,11,11,0,2667
20210427,경기,194,189,5,33863
20210427,세종,2,2,0,356
20210427,울산,33,33,0,1772
20210427,대전,10,10,0,1695
20210427,광주,12,11,1,2397
20210427,인천,20,19,1,5626
20210427,대구,29,27,2,9318
20210427,부산,33,32,1,4977
20210427,서울,257,255,2,37383
20210427,합계,769,748,21,120667
20210426,검역,23,0,23,3445
20210426,제주,5,5,0,702
20210426,경남,28,27,1,3785
20210426,경북,22,20,2,4028
20210426,전남,2,2,0,1041
20210426,전북,5,4,1,1893
20210426,충남,14,14,0,2967
20210426,충북,10,9,1,2584
20210426,강원,2,2,0,2656
20210426,경기,195,191,4,33669
20210426,세종,2,2,0,354
20210426,울산,18,18,0,1739
20210426,대전,8,8,0,1685
20210426,광주,6,6,0,2385
20210426,인천,14,14,0,5606
20210426,대구,12,9,3,9289
20210426,부산,30,30,0,4944
20210426,서울,116,116,0,37126
20210426,합계,512,477,35,119898
20210425,검역,20,0,20,3420
20210425,제주,1,1,0,697
20210425,경남,29,29,0,3757
20210425,경북,25,24,1,4006
20210425,전남,0,0,0,1039
20210425,전북,6,5,1,1888
20210425,충남,7,7,0,2953
20210425,충북,16,16,0,2574
20210425,강원,12,12,0,2654
20210425,경기,150,147,3,33474
20210425,세종,1,1,0,352
20210425,울산,13,13,0,1721
20210425,대전,4,4,0,1677
20210425,광주,15,15,0,2379
20210425,인천,14,13,1,5592
20210425,대구,7,7,0,9277
20210425,부산,25,23,2,4914
20210425,서울,154,152,2,37010
20210425,합계,499,469,30,119386
20210424,검역,30,0,30,3402
20210424,제주,3,3,0,696
20210424,경남,45,44,1,3728
20210424,경북,24,23,1,3981
20210424,전남,9,9,0,1039
20210424,전북,7,7,0,1882
20210424,충남,6,6,0,2946
20210424,충북,15,15,0,2558
20210424,강원,10,9,1,2642
20210424,경기,191,187,4,33324
20210424,세종,0,0,0,351
20210424,울산,43,43,0,1708
20210424,대전,6,6,0,1673
20210424,광주,8,8,0,2364
20210424,인천,15,15,0,5578
20210424,대구,14,13,1,9270
20210424,부산,43,43,0,4889
20210424,서울,175,172,3,36856
20210424,합계,644,603,41,118887
20210423,검역,11,0,11,3372
20210423,제주,3,3,0,693
20210423,경남,52,52,0,3683
20210423,경북,32,30,2,3957
20210423,전남,1,1,0,1030
20210423,전북,9,6,3,1875
20210423,충남,14,13,1,2940
20210423,충북,15,13,2,2543
20210423,강원,9,9,0,2632
20210423,경기,244,240,4,33133
20210423,세종,1,1,0,351
20210423,울산,50,50,0,1665
20210423,대전,10,10,0,1667
20210423,광주,15,15,0,2356
20210423,인천,18,17,1,5563
20210423,대구,4,4,0,9256
20210423,부산,44,44,0,4846
20210423,서울,253,251,2,36681
20210423,합계,785,760,25,118243
20210422,검역,23,0,23,3361
20210422,제주,3,3,0,690
20210422,경남,63,63,0,3631
20210422,경북,22,22,0,3925
20210422,전남,6,6,0,1029
20210422,전북,9,8,1,1866
20210422,충남,10,10,0,2926
20210422,충북,30,29,1,2528
20210422,강원,15,15,0,2623
20210422,경기,298,290,8,32889
20210422,세종,3,3,0,350
20210422,울산,38,38,0,1615
20210422,대전,2,2,0,1657
20210422,광주,16,16,0,2341
20210422,인천,10,10,0,5545
20210422,대구,12,12,0,9252
20210422,부산,33,33,0,4802
20210422,서울,204,198,6,36428
20210422,합계,797,758,39,117458
20210421,검역,5,0,5,3338
20210421,제주,4,4,0,687
20210421,경남,58,58,0,3568
20210421,경북,23,23,0,3903
20210421,전남,8,7,1,1023
20210421,전북,6,6,0,1857
20210421,충남,6,4,2,2916
20210421,충북,19,19,0,2498
20210421,강원,24,23,1,2608
20210421,경기,222,217,5,32591
20210421,세종,1,1,0,347
20210421,울산,32,32,0,1577
20210421,대전,13,13,0,1655
20210421,광주,9,9,0,2325
20210421,인천,14,11,3,5535
20210421,대구,24,24,0,9240
20210421,부산,37,35,2,4769
20210421,서울,230,229,1,36224
20210421,합계,735,715,20,116661
20210420,검역,13,0,13,3333
20210420,제주,7,6,1,683
20210420,경남,41,40,1,3510
20210420,경북,16,15,1,3880
20210420,전남,4,2,2,1015
20210420,전북,8,8,0,1851
20210420,충남,8,7,1,2910
20210420,충북,20,19,1,2479
20210420,강원,15,14,1,2584
20210420,경기,234,225,9,32369
20210420,세종,1,1,0,346
20210420,울산,39,39,0,1545
20210420,대전,17,17,0,1642
20210420,광주,17,17,0,2316
20210420,인천,15,13,2,5521
20210420,대구,25,25,0,9216
20210420,부산,33,33,0,4732
20210420,서울,218,211,7,35994
20210420,합계,731,692,39,115926
20210419,검역,10,0,10,3320
20210419,제주,1,1,0,676
20210419,경남,29,29,0,3469
20210419,경북,21,20,1,3864
20210419,전남,4,4,0,1011
20210419,전북,3,3,0,1843
20210419,충남,16,16,0,2902
20210419,충북,14,14,0,2459
20210419,강원,18,18,0,2569
20210419,경기,189,184,5,32135
20210419,세종,1,1,0,345
20210419,울산,21,21,0,1506
20210419,대전,8,8,0,1625
20210419,광주,4,4,0,2299
20210419,인천,18,18,0,5506
20210419,대구,15,12,3,9191
20210419,부산,29,29,0,4699
20210419,서울,148,147,1,35776
20210419,합계,549,529,20,115195
20210418,검역,8,0,8,3310
20210418,제주,2,2,0,675
20210418,경남,35,35,0,3440
20210418,경북,19,17,2,3843
20210418,전남,3,2,1,1007
20210418,전북,16,16,0,1840
20210418,충남,13,13,0,2886
20210418,충북,10,9,1,2445
20210418,강원,21,21,0,2551
20210418,경기,146,142,4,31946
20210418,세종,1,1,0,344
20210418,울산,28,28,0,1485
20210418,대전,21,21,0,1617
20210418,광주,11,11,0,2295
20210418,인천,11,10,1,5488
20210418,대구,24,23,1,9176
20210418,부산,26,25,1,4670
20210418,서울,137,136,1,35628
20210418,합계,532,512,20,114646
20210417,검역,9,0,9,3302
20210417,제주,1,1,0,673
20210417,경남,67,67,0,3405
20210417,경북,28,26,2,3824
20210417,전남,2,2,0,1004
20210417,전북,21,21,0,1824
20210417,충남,22,19,3,2873
20210417,충북,10,10,0,2435
20210417,강원,19,19,0,2530
20210417,경기,184,181,3,31800
20210417,세종,2,2,0,343
20210417,울산,21,20,1,1457
20210417,대전,5,5,0,1596
20210417,광주,13,12,1,2284
20210417,인천,19,19,0,5477
20210417,대구,13,13,0,9152
20210417,부산,31,30,1,4644
20210417,서울,205,202,3,35492
20210417,합계,672,649,23,114115
20210416,검역,7,0,7,3293
20210416,제주,1,1,0,672
20210416,경남,38,36,2,3338
20210416,경북,29,28,1,3796
20210416,전남,6,6,0,1002
20210416,전북,16,15,1,1803
20210416,충남,7,6,1,2851
20210416,충북,12,11,1,2425
20210416,강원,12,11,1,2511
20210416,경기,209,204,5,31616
20210416,세종,0,0,0,341
20210416,울산,26,25,1,1436
20210416,대전,4,4,0,1591
20210416,광주,4,4,0,2271
20210416,인천,23,23,0,5458
20210416,대구,12,10,2,9139
20210416,부산,35,33,2,4614
20210416,서울,217,213,4,35287
20210416,합계,658,630,28,113444
20210415,검역,11,0,11,3286
20210415,제주,3,3,0,671
20210415,경남,44,44,0,3300
20210415,경북,24,23,1,3767
20210415,전남,6,6,0,996
20210415,전북,15,15,0,1787
20210415,충남,13,12,1,2844
20210415,충북,9,9,0,2413
20210415,강원,7,7,0,2499
20210415,경기,221,216,5,31407
20210415,세종,3,3,0,341
20210415,울산,24,24,0,1410
20210415,대전,6,6,0,1587
20210415,광주,11,10,1,2267
20210415,인천,12,11,1,5435
20210415,대구,4,4,0,9127
20210415,부산,44,44,0,4579
20210415,서울,216,215,1,35070
20210415,합계,673,652,21,112786
20210414,검역,15,0,15,3275
20210414,제주,3,1,2,668
20210414,경남,24,22,2,3256
20210414,경북,19,19,0,3743
20210414,전남,11,11,0,990
20210414,전북,16,15,1,1772
20210414,충남,4,4,0,2831
20210414,충북,20,19,1,2404
20210414,강원,18,18,0,2492
20210414,경기,224,222,2,31189
20210414,세종,3,3,0,338
20210414,울산,21,21,0,1386
20210414,대전,10,10,0,1581
20210414,광주,4,3,1,2256
20210414,인천,17,16,1,5423
20210414,대구,18,16,2,9123
20210414,부산,54,54,0,4535
20210414,서울,216,215,1,34854
20210414,합계,698,670,28,112113
20210413,검역,12,0,12,3260
20210413,제주,2,1,1,665
20210413,경남,27,27,0,3232
20210413,경북,14,14,0,3724
20210413,전남,1,1,0,979
20210413,전북,11,10,1,1756
20210413,충남,10,10,0,2827
20210413,충북,29,29,0,2384
20210413,강원,6,6,0,2474
20210413,경기,238,238,0,30965
20210413,세종,2,2,0,335
20210413,울산,30,30,0,1365
20210413,대전,11,11,0,1571
20210413,광주,5,5,0,2252
20210413,인천,26,26,0,5406
20210413,대구,11,11,0,9105
20210413,부산,49,48,1,4481
20210413,서울,246,244,2,34637
20210413,합계,730,713,17,111418
20210412,검역,5,0,5,3248
20210412,제주,0,0,0,663
20210412,경남,15,15,0,3205
20210412,경북,10,10,0,3710
20210412,전남,6,6,0,978
20210412,전북,25,25,0,1745
20210412,충남,14,14,0,2817
20210412,충북,8,7,1,2355
20210412,강원,13,12,1,2468
20210412,경기,168,163,5,30727
20210412,세종,2,2,0,333
20210412,울산,32,32,0,1335
20210412,대전,13,13,0,1560
20210412,광주,9,9,0,2247
20210412,인천,16,16,0,5380
20210412,대구,9,9,0,9094
20210412,부산,39,39,0,4432
20210412,서울,157,155,2,34390
20210412,합계,541,527,14,110687
20210411,검역,8,0,8,3243
20210411,제주,3,3,0,663
20210411,경남,17,15,2,3190
20210411,경북,15,15,0,3700
20210411,전남,3,3,0,972
20210411,전북,24,24,0,1720
20210411,충남,18,16,2,2803
20210411,충북,20,17,3,2347
20210411,강원,6,4,2,2455
20210411,경기,176,173,3,30559
20210411,세종,5,5,0,331
20210411,울산,34,31,3,1303
20210411,대전,17,17,0,1547
20210411,광주,4,4,0,2238
20210411,인천,12,12,0,5364
20210411,대구,16,15,1,9085
20210411,부산,47,46,1,4393
20210411,서울,161,159,2,34232
20210411,합계,586,559,27,110145
20210410,검역,8,0,8,3235
20210410,제주,7,7,0,660
20210410,경남,16,15,1,3173
20210410,경북,13,12,1,3685
20210410,전남,6,6,0,969
20210410,전북,40,40,0,1696
20210410,충남,22,22,0,2785
20210410,충북,10,10,0,2327
20210410,강원,5,5,0,2449
20210410,경기,186,182,4,30383
20210410,세종,1,1,0,326
20210410,울산,11,10,1,1269
20210410,대전,7,7,0,1530
20210410,광주,0,0,0,2234
20210410,인천,17,16,1,5352
20210410,대구,6,6,0,9069
20210410,부산,45,44,1,4346
20210410,서울,213,210,3,34070
20210410,합계,613,593,20,109558
20210409,검역,4,0,4,3227
20210409,제주,7,7,0,653
20210409,경남,46,44,2,3157
20210409,경북,26,26,0,3672
20210409,전남,7,7,0,963
20210409,전북,23,23,0,1656
20210409,충남,15,15,0,2763
20210409,충북,12,10,2,2317
20210409,강원,6,6,0,2444
20210409,경기,202,199,3,30197
20210409,세종,4,4,0,325
20210409,울산,25,25,0,1258
20210409,대전,13,13,0,1523
20210409,광주,1,1,0,2234
20210409,인천,24,24,0,5335
20210409,대구,5,4,1,9063
20210409,부산,56,56,0,4301
20210409,서울,200,197,3,33856
20210409,합계,676,661,15,108944
20210408,검역,7,0,7,3223
20210408,제주,2,2,0,646
20210408,경남,15,15,0,3111
20210408,경북,7,7,0,3646
20210408,전남,11,9,2,956
20210408,전북,22,22,0,1633
20210408,충남,18,17,1,2748
20210408,충북,7,7,0,2305
20210408,강원,3,3,0,2438
20210408,경기,203,197,6,29995
20210408,세종,5,5,0,321
20210408,울산,9,9,0,1233
20210408,대전,26,26,0,1510
20210408,광주,5,5,0,2233
20210408,인천,45,39,6,5311
20210408,대구,17,16,1,9058
20210408,부산,53,50,3,4245
20210408,서울,214,213,1,33655
20210408,합계,670,643,27,108267
20210407,검역,7,0,7,3216
20210407,제주,5,5,0,644
20210407,경남,11,10,1,3096
20210407,경북,11,11,0,3639
20210407,전남,1,1,0,945
20210407,전북,24,24,0,1611
20210407,충남,20,18,2,2730
20210407,충북,8,8,0,2298
20210407,강원,7,6,1,2435
20210407,경기,230,223,7,29792
20210407,세종,7,7,0,316
20210407,울산,13,13,0,1224
20210407,대전,25,25,0,1484
20210407,광주,0,0,0,2228
20210407,인천,25,23,2,5266
20210407,대구,9,9,0,9040
20210407,부산,52,51,1,4192
20210407,서울,243,238,5,33440
20210407,합계,700,674,26,107596
20210406,검역,4,0,4,3209
20210406,제주,3,3,0,639
20210406,경남,25,25,0,3085
20210406,경북,9,9,0,3628
20210406,전남,7,7,0,944
20210406,전북,10,10,0,1587
20210406,충남,12,11,1,2710
20210406,충북,17,15,2,2290
20210406,강원,16,16,0,2428
20210406,경기,175,173,2,29562
20210406,세종,1,1,0,309
20210406,울산,26,26,0,1211
20210406,대전,61,61,0,1459
20210406,광주,2,2,0,2228
20210406,인천,48,44,4,5241
20210406,대구,15,15,0,9030
20210406,부산,38,38,0,4140
20210406,서울,197,195,2,33196
20210406,합계,668,653,15,106896
20210405,검역,5,0,5,3205
20210405,제주,0,0,0,636
20210405,경남,7,7,0,3060
20210405,경북,25,25,0,3619
20210405,전남,15,15,0,937
20210405,전북,29,29,0,1577
20210405,충남,6,4,2,2698
20210405,충북,12,10,2,2273
20210405,강원,15,15,0,2412
20210405,경기,107,100,7,29387
20210405,세종,0,0,0,308
20210405,울산,4,4,0,1185
20210405,대전,22,22,0,1398
20210405,광주,6,6,0,2226
20210405,인천,27,27,0,5193
20210405,대구,16,16,0,9014
20210405,부산,34,34,0,4102
20210405,서울,146,144,2,32998
20210405,합계,477,459,18,106228
20210404,검역,10,0,10,3200
20210404,제주,2,2,0,636
20210404,경남,12,11,1,3053
20210404,경북,20,20,0,3594
20210404,전남,5,3,2,922
20210404,전북,16,16,0,1548
20210404,충남,14,14,0,2692
20210404,충북,7,7,0,2261
20210404,강원,14,14,0,2397
20210404,경기,111,108,3,29280
20210404,세종,4,4,0,308
20210404,울산,1,1,0,1181
20210404,대전,13,13,0,1376
20210404,광주,0,0,0,2220
20210404,인천,22,19,3,5166
20210404,대구,22,22,0,8998
20210404,부산,48,46,2,4068
20210404,서울,151,148,3,32851
20210404,합계,472,448,24,105751
20210403,검역,10,0,10,3190
20210403,제주,2,2,0,634
20210403,경남,14,13,1,3041
20210403,경북,16,13,3,3574
20210403,전남,1,1,0,917
20210403,전북,24,23,1,1532
20210403,충남,12,10,2,2678
20210403,충북,14,14,0,2254
20210403,강원,6,6,0,2383
20210403,경기,150,146,4,29169
20210403,세종,3,3,0,304
20210403,울산,11,11,0,1180
20210403,대전,29,28,1,1363
20210403,광주,4,4,0,2220
20210403,인천,22,19,3,5144
20210403,대구,15,15,0,8976
20210403,부산,61,60,1,4020
20210403,서울,148,145,3,32699
20210403,합계,543,514,29,105278
20210402,검역,9,0,9,3180
20210402,제주,1,1,0,632
20210402,경남,28,28,0,3027
20210402,경북,17,16,1,3558
20210402,전남,1,1,0,916
20210402,전북,20,20,0,1508
20210402,충남,10,7,3,2666
20210402,충북,11,11,0,2240
20210402,강원,17,16,1,2377
20210402,경기,147,143,4,29019
20210402,세종,10,10,0,301
20210402,울산,3,3,0,1169
20210402,대전,19,19,0,1334
20210402,광주,3,2,1,2216
20210402,인천,21,19,2,5122
20210402,대구,10,10,0,8961
20210402,부산,61,61,0,3959
20210402,서울,154,153,1,32550
20210402,합계,543,521,22,104735
20210401,검역,11,0,11,3171
20210401,제주,4,4,0,631
20210401,경남,18,18,0,2999
20210401,경북,30,28,2,3541
20210401,전남,1,1,0,915
20210401,전북,15,15,0,1488
20210401,충남,10,8,2,2656
20210401,충북,19,19,0,2229
20210401,강원,10,10,0,2360
20210401,경기,160,156,4,28872
20210401,세종,8,8,0,291
20210401,울산,7,7,0,1166
20210401,대전,19,19,0,1315
20210401,광주,1,1,0,2213
20210401,인천,23,22,1,5101
20210401,대구,17,17,0,8951
20210401,부산,38,35,3,3898
20210401,서울,166,164,2,32395
20210401,합계,557,532,25,104192
20210331,검역,2,0,2,3160
20210331,제주,2,2,0,627
20210331,경남,21,21,0,2981
20210331,경북,7,6,1,3511
20210331,전남,1,1,0,914
20210331,전북,22,22,0,1473
20210331,충남,15,15,0,2646
20210331,충북,20,19,1,2210
20210331,강원,20,20,0,2350
20210331,경기,130,125,5,28712
20210331,세종,13,13,0,283
20210331,울산,5,5,0,1159
20210331,대전,10,10,0,1296
20210331,광주,3,1,2,2212
20210331,인천,20,20,0,5078
20210331,대구,7,7,0,8934
20210331,부산,54,53,1,3860
20210331,서울,195,193,2,32229
20210331,합계,551,534,14,103635
20210330,검역,7,0,7,3158
20210330,제주,2,2,0,625
20210330,경남,22,21,1,2960
20210330,경북,6,6,0,3504
20210330,전남,0,0,0,913
20210330,전북,20,20,0,1451
20210330,충남,8,8,0,2631
20210330,충북,21,21,0,2190
20210330,강원,16,16,0,2330
20210330,경기,111,106,5,28582
20210330,세종,17,17,0,270
20210330,울산,11,11,0,1154
20210330,대전,7,7,0,1286
20210330,광주,2,2,0,2209
20210330,인천,25,25,0,5058
20210330,대구,15,15,0,8927
20210330,부산,58,58,0,3806
20210330,서울,154,152,2,32030
20210330,합계,506,491,15,103084
20210329,검역,3,0,3,3151
20210329,제주,0,0,0,623
20210329,경남,16,15,1,2938
20210329,경북,5,4,1,3498
20210329,전남,0,0,0,913
20210329,전북,25,25,0,1431
20210329,충남,5,4,1,2623
20210329,충북,28,27,1,2169
20210329,강원,13,13,0,2314
20210329,경기,117,112,5,28471
20210329,세종,2,2,0,253
20210329,울산,3,3,0,1143
20210329,대전,11,11,0,1279
20210329,광주,1,1,0,2207
20210329,인천,18,18,0,5033
20210329,대구,12,12,0,8912
20210329,부산,43,42,1,3748
20210329,서울,145,140,5,31872
20210329,합계,447,429,18,102578
20210328,검역,4,0,4,3148
20210328,제주,1,0,1,623
20210328,경남,20,18,2,2922
20210328,경북,3,3,0,3493
20210328,전남,1,0,1,913
20210328,전북,8,8,0,1406
20210328,충남,1,1,0,2618
20210328,충북,12,11,1,2141
20210328,강원,6,6,0,2301
20210328,경기,131,130,1,28354
20210328,세종,0,0,0,251
20210328,울산,3,3,0,1140
20210328,대전,2,2,0,1268
20210328,광주,2,2,0,2206
20210328,인천,18,18,0,5015
20210328,대구,10,9,1,8900
20210328,부산,53,53,0,3705
20210328,서울,107,105,2,31727
20210328,합계,382,369,13,102131
20210327,검역,9,0,9,3144
20210327,제주,0,0,0,622
20210327,경남,13,13,0,2902
20210327,경북,7,7,0,3490
20210327,전남,1,0,1,912
20210327,전북,5,5,0,1398
20210327,충남,8,8,0,2617
20210327,충북,16,16,0,2129
20210327,강원,19,19,0,2295
20210327,경기,153,150,3,28223
20210327,세종,0,0,0,251
20210327,울산,4,4,0,1137
20210327,대전,8,6,2,1266
20210327,광주,2,2,0,2204
20210327,인천,33,32,1,4997
20210327,대구,10,9,1,8890
20210327,부산,56,56,0,3652
20210327,서울,138,135,3,31620
20210327,합계,482,462,20,101749
20210326,검역,3,0,3,3135
20210326,제주,2,2,0,622
20210326,경남,19,19,0,2889
20210326,경북,11,10,1,3483
20210326,전남,0,0,0,911
20210326,전북,5,4,1,1393
20210326,충남,2,2,0,2609
20210326,충북,39,38,1,2113
20210326,강원,36,35,1,2276
20210326,경기,145,141,4,28070
20210326,세종,1,1,0,251
20210326,울산,5,3,2,1133
20210326,대전,10,10,0,1258
20210326,광주,5,5,0,2202
20210326,인천,39,39,0,4964
20210326,대구,23,22,1,8880
20210326,부산,33,33,0,3596
20210326,서울,127,126,1,31482
20210326,합계,505,490,15,101267
20210325,검역,3,0,3,3132
20210325,제주,3,2,1,620
20210325,경남,37,37,0,2870
20210325,경북,13,12,1,3472
20210325,전남,2,2,0,911
20210325,전북,3,3,0,1388
20210325,충남,3,2,1,2607
20210325,충북,13,9,4,2074
20210325,강원,24,24,0,2240
20210325,경기,196,187,9,27925
20210325,세종,0,0,0,250
20210325,울산,0,0,0,1128
20210325,대전,14,13,1,1248
20210325,광주,3,2,1,2197
20210325,인천,29,28,1,4925
20210325,대구,14,14,0,8857
20210325,부산,11,11,0,3563
20210325,서울,121,120,1,31355
20210325,합계,489,466,23,100762
20210324,검역,5,0,5,3129
20210324,제주,0,0,0,617
20210324,경남,30,30,0,2833
20210324,경북,10,9,1,3459
20210324,전남,1,1,0,909
20210324,전북,5,4,1,1385
20210324,충남,4,4,0,2604
20210324,충북,17,17,0,2061
20210324,강원,27,27,0,2216
20210324,경기,147,147,0,27729
20210324,세종,0,0,0,250
20210324,울산,0,0,0,1128
20210324,대전,3,3,0,1234
20210324,광주,5,4,1,2194
20210324,인천,12,11,1,4896
20210324,대구,17,17,0,8843
20210324,부산,20,20,0,3552
20210324,서울,124,122,2,31234
20210324,합계,427,416,11,100273
20210323,검역,8,0,8,3124
20210323,제주,0,0,0,617
20210323,경남,27,27,0,2803
20210323,경북,12,12,0,3449
20210323,전남,0,0,0,908
20210323,전북,5,4,1,1380
20210323,충남,0,0,0,2600
20210323,충북,6,6,0,2044
20210323,강원,18,18,0,2189
20210323,경기,154,150,4,27582
20210323,세종,0,0,0,250
20210323,울산,2,1,1,1128
20210323,대전,2,2,0,1231
20210323,광주,2,2,0,2189
20210323,인천,21,21,0,4884
20210323,대구,17,17,0,8826
20210323,부산,17,16,1,3532
20210323,서울,134,132,2,31107
20210323,합계,425,408,17,99843
20210322,검역,8,0,8,3116
20210322,제주,0,0,0,617
20210322,경남,29,29,0,2776
20210322,경북,20,19,1,3437
20210322,전남,1,1,0,908
20210322,전북,7,7,0,1375
20210322,충남,8,7,1,2600
20210322,충북,6,6,0,2038
20210322,강원,9,9,0,2171
20210322,경기,124,120,4,27428
20210322,세종,0,0,0,250
20210322,울산,8,8,0,1126
20210322,대전,4,4,0,1229
20210322,광주,1,1,0,2187
20210322,인천,13,12,1,4863
20210322,대구,3,3,0,8809
20210322,부산,8,8,0,3515
20210322,서울,94,94,0,30973
20210322,합계,343,328,15,99418
20210321,검역,7,0,7,3108
20210321,제주,1,1,0,617
20210321,경남,37,37,0,2747
20210321,경북,11,10,1,3417
20210321,전남,2,2,0,907
20210321,전북,7,7,0,1368
20210321,충남,11,11,0,2592
20210321,충북,5,5,0,2032
20210321,강원,21,21,0,2162
20210321,경기,151,143,8,27304
20210321,세종,0,0,0,250
20210321,울산,1,1,0,1118
20210321,대전,0,0,0,1225
20210321,광주,2,2,0,2186
20210321,인천,10,10,0,4850
20210321,대구,14,14,0,8806
20210321,부산,26,24,2,3507
20210321,서울,103,102,1,30873
20210321,합계,409,390,19,99069
20210320,검역,9,0,9,3101
20210320,제주,1,1,0,616
20210320,경남,54,54,0,2710
20210320,경북,5,5,0,3406
20210320,전남,0,0,0,905
20210320,전북,11,10,1,1361
20210320,충남,5,5,0,2581
20210320,충북,10,10,0,2027
20210320,강원,14,13,1,2141
20210320,경기,157,155,2,27153
20210320,세종,0,0,0,250
20210320,울산,7,7,0,1117
20210320,대전,1,1,0,1225
20210320,광주,2,2,0,2184
20210320,인천,22,20,2,4840
20210320,대구,14,12,2,8792
20210320,부산,19,18,1,3481
20210320,서울,125,124,1,30764
20210320,합계,456,437,19,98654
20210319,검역,4,0,4,3092
20210319,제주,1,1,0,615
20210319,경남,31,31,0,2656
20210319,경북,11,11,0,3401
20210319,전남,0,0,0,905
20210319,전북,16,14,2,1350
20210319,충남,6,5,1,2576
20210319,충북,8,8,0,2017
20210319,강원,17,17,0,2127
20210319,경기,189,187,2,26996
20210319,세종,0,0,0,250
20210319,울산,3,3,0,1110
20210319,대전,8,8,0,1224
20210319,광주,1,0,1,2182
20210319,인천,12,11,1,4818
20210319,대구,16,16,0,8778
20210319,부산,9,9,0,3462
20210319,서울,115,114,1,30639
20210319,합계,447,435,12,98204
20210318,검역,7,0,7,3088
20210318,제주,0,0,0,614
20210318,경남,42,42,0,2625
20210318,경북,4,4,0,3390
20210318,전남,0,0,0,905
20210318,전북,15,15,0,1334
20210318,충남,5,3,2,2570
20210318,충북,8,6,2,2009
20210318,강원,31,30,1,2110
20210318,경기,157,153,4,26807
20210318,세종,0,0,0,250
20210318,울산,3,2,1,1107
20210318,대전,7,7,0,1216
20210318,광주,2,2,0,2181
20210318,인천,24,23,1,4806
20210318,대구,5,4,1,8762
20210318,부산,7,6,1,3453
20210318,서울,146,144,2,30524
20210318,합계,463,441,22,97751
20210317,검역,9,0,9,3081
20210317,제주,2,1,1,614
20210317,경남,35,35,0,2583
20210317,경북,5,5,0,3386
20210317,전남,0,0,0,905
20210317,전북,15,15,0,1319
20210317,충남,14,13,1,2565
20210317,충북,8,8,0,2001
20210317,강원,23,23,0,2079
20210317,경기,159,155,4,26650
20210317,세종,1,1,0,250
20210317,울산,5,5,0,1104
20210317,대전,2,2,0,1209
20210317,광주,1,0,1,2179
20210317,인천,21,20,1,4782
20210317,대구,14,13,1,8757
20210317,부산,7,7,0,3446
20210317,서울,124,124,0,30378
20210317,합계,445,427,18,97288
20210316,검역,9,0,9,3072
20210316,제주,1,1,0,612
20210316,경남,45,45,0,2548
20210316,경북,4,4,0,3381
20210316,전남,0,0,0,905
20210316,전북,21,21,0,1304
20210316,충남,6,6,0,2551
20210316,충북,12,12,0,1993
20210316,강원,10,10,0,2056
20210316,경기,186,182,4,26491
20210316,세종,3,2,1,249
20210316,울산,4,3,1,1099
20210316,대전,1,1,0,1207
20210316,광주,1,0,1,2178
20210316,인천,21,21,0,4761
20210316,대구,14,14,0,8743
20210316,부산,11,10,1,3439
20210316,서울,120,120,0,30254
20210316,합계,469,452,17,96843
20210315,검역,7,0,7,3063
20210315,제주,2,2,0,611
20210315,경남,65,64,1,2503
20210315,경북,4,4,0,3377
20210315,전남,1,1,0,905
20210315,전북,7,6,1,1283
20210315,충남,4,4,0,2545
20210315,충북,3,3,0,1981
20210315,강원,13,12,1,2046
20210315,경기,148,146,2,26305
20210315,세종,0,0,0,246
20210315,울산,3,3,0,1095
20210315,대전,1,1,0,1206
20210315,광주,2,1,1,2177
20210315,인천,14,14,0,4740
20210315,대구,3,3,0,8729
20210315,부산,7,6,1,3428
20210315,서울,79,75,4,30134
20210315,합계,363,345,18,96374
20210314,검역,7,0,7,3056
20210314,제주,3,3,0,609
20210314,경남,31,31,0,2438
20210314,경북,3,3,0,3373
20210314,전남,1,0,1,904
20210314,전북,5,4,1,1276
20210314,충남,6,5,1,2541
20210314,충북,9,9,0,1978
20210314,강원,10,10,0,2033
20210314,경기,161,161,0,26157
20210314,세종,2,2,0,246
20210314,울산,2,1,1,1092
20210314,대전,2,2,0,1205
20210314,광주,1,1,0,2175
20210314,인천,18,18,0,4726
20210314,대구,5,4,1,8726
20210314,부산,4,4,0,3421
20210314,서울,109,109,0,30055
20210314,합계,379,367,12,96011
20210313,검역,6,0,6,3049
20210313,제주,1,1,0,606
20210313,경남,53,52,1,2407
20210313,경북,9,7,2,3370
20210313,전남,2,2,0,903
20210313,전북,7,5,2,1271
20210313,충남,2,1,1,2535
20210313,충북,7,7,0,1969
20210313,강원,16,16,0,2023
20210313,경기,203,199,4,25996
20210313,세종,0,0,0,244
20210313,울산,1,1,0,1090
20210313,대전,0,0,0,1203
20210313,광주,1,1,0,2174
20210313,인천,20,19,1,4708
20210313,대구,6,4,2,8721
20210313,부산,13,13,0,3417
20210313,서울,112,108,4,29949
20210313,합계,459,436,23,95635
20210312,검역,6,0,6,3043
20210312,제주,1,1,0,605
20210312,경남,62,61,1,2354
20210312,경북,14,12,2,3361
20210312,전남,1,1,0,901
20210312,전북,2,2,0,1264
20210312,충남,9,9,0,2533
20210312,충북,16,16,0,1962
20210312,강원,18,18,0,2007
20210312,경기,164,160,4,25793
20210312,세종,0,0,0,244
20210312,울산,1,1,0,1089
20210312,대전,1,1,0,1203
20210312,광주,3,2,1,2173
20210312,인천,26,26,0,4688
20210312,대구,9,9,0,8715
20210312,부산,17,17,0,3404
20210312,서울,140,138,2,29837
20210312,합계,490,474,16,95176
20210311,검역,6,0,6,3037
20210311,제주,2,2,0,604
20210311,경남,56,56,0,2292
20210311,경북,9,9,0,3347
20210311,전남,4,4,0,900
20210311,전북,4,4,0,1262
20210311,충남,3,3,0,2524
20210311,충북,27,27,0,1946
20210311,강원,12,12,0,1989
20210311,경기,166,157,9,25629
20210311,세종,2,2,0,244
20210311,울산,5,4,1,1088
20210311,대전,0,0,0,1202
20210311,광주,2,2,0,2170
20210311,인천,31,29,2,4662
20210311,대구,4,4,0,8706
20210311,부산,15,14,1,3387
20210311,서울,140,138,2,29697
20210311,합계,488,467,21,94686
20210310,검역,10,0,10,3031
20210310,제주,2,2,0,602
20210310,경남,8,7,1,2236
20210310,경북,11,10,1,3338
20210310,전남,3,3,0,896
20210310,전북,8,7,1,1258
20210310,충남,4,4,0,2521
20210310,충북,6,6,0,1919
20210310,강원,30,30,0,1977
20210310,경기,184,178,6,25463
20210310,세종,0,0,0,242
20210310,울산,23,23,0,1083
20210310,대전,1,1,0,1202
20210310,광주,1,1,0,2168
20210310,인천,18,18,0,4631
20210310,대구,4,4,0,8702
20210310,부산,14,13,1,3372
20210310,서울,138,137,1,29557
20210310,합계,465,444,21,94198
20210309,검역,5,0,5,3021
20210309,제주,2,2,0,600
20210309,경남,7,7,0,2228
20210309,경북,4,4,0,3327
20210309,전남,3,3,0,893
20210309,전북,5,5,0,1250
20210309,충남,6,6,0,2517
20210309,충북,21,18,3,1913
20210309,강원,20,20,0,1947
20210309,경기,203,199,4,25279
20210309,세종,0,0,0,242
20210309,울산,21,21,0,1060
20210309,대전,3,3,0,1201
20210309,광주,1,1,0,2167
20210309,인천,23,23,0,4613
20210309,대구,1,1,0,8698
20210309,부산,7,7,0,3358
20210309,서울,138,132,6,29419
20210309,합계,470,452,18,93733
20210308,검역,4,0,4,3016
20210308,제주,2,2,0,598
20210308,경남,1,1,0,2221
20210308,경북,2,2,0,3323
20210308,전남,3,2,1,890
20210308,전북,8,7,1,1245
20210308,충남,15,14,1,2511
20210308,충북,21,21,0,1892
20210308,강원,13,13,0,1927
20210308,경기,188,181,7,25076
20210308,세종,0,0,0,242
20210308,울산,11,11,0,1039
20210308,대전,1,1,0,1198
20210308,광주,33,32,1,2166
20210308,인천,20,20,0,4590
20210308,대구,3,3,0,8697
20210308,부산,19,19,0,3351
20210308,서울,102,98,4,29281
20210308,합계,446,427,19,93263
20210307,검역,5,0,5,3012
20210307,제주,3,3,0,596
20210307,경남,1,0,1,2220
20210307,경북,3,2,1,3321
20210307,전남,6,6,0,887
20210307,전북,4,4,0,1237
20210307,충남,14,14,0,2496
20210307,충북,20,20,0,1871
20210307,강원,10,10,0,1914
20210307,경기,128,128,0,24888
20210307,세종,1,1,0,242
20210307,울산,3,3,0,1028
20210307,대전,0,0,0,1197
20210307,광주,15,14,1,2133
20210307,인천,15,15,0,4570
20210307,대구,6,6,0,8694
20210307,부산,12,12,0,3332
20210307,서울,100,97,3,29179
20210307,합계,346,335,11,92817
20210306,검역,5,0,5,3007
20210306,제주,4,4,0,593
20210306,경남,3,3,0,2219
20210306,경북,13,11,2,3318
20210306,전남,6,6,0,881
20210306,전북,5,5,0,1233
20210306,충남,6,6,0,2482
20210306,충북,9,8,1,1851
20210306,강원,10,10,0,1904
20210306,경기,172,169,3,24760
20210306,세종,2,2,0,241
20210306,울산,2,2,0,1025
20210306,대전,1,1,0,1197
20210306,광주,4,4,0,2118
20210306,인천,28,27,1,4555
20210306,대구,8,8,0,8688
20210306,부산,6,6,0,3320
20210306,서울,132,127,5,29079
20210306,합계,416,399,17,92471
20210305,검역,6,0,6,3002
20210305,제주,5,5,0,589
20210305,경남,5,5,0,2216
20210305,경북,13,13,0,3305
20210305,전남,3,3,0,875
20210305,전북,4,4,0,1228
20210305,충남,7,7,0,2476
20210305,충북,22,22,0,1842
20210305,강원,7,7,0,1894
20210305,경기,173,172,1,24588
20210305,세종,2,1,1,239
20210305,울산,4,4,0,1023
20210305,대전,0,0,0,1196
20210305,광주,3,1,2,2114
20210305,인천,20,19,1,4527
20210305,대구,4,3,1,8680
20210305,부산,12,12,0,3314
20210305,서울,128,126,2,28947
20210305,합계,418,404,14,92055
20210304,검역,4,0,4,2996
20210304,제주,2,2,0,584
20210304,경남,3,3,0,2211
20210304,경북,6,4,2,3292
20210304,전남,0,0,0,872
20210304,전북,3,3,0,1224
20210304,충남,9,8,1,2469
20210304,충북,19,19,0,1820
20210304,강원,4,4,0,1887
20210304,경기,173,168,5,24415
20210304,세종,1,1,0,237
20210304,울산,3,0,3,1019
20210304,대전,0,0,0,1196
20210304,광주,6,5,1,2111
20210304,인천,13,12,1,4507
20210304,대구,3,3,0,8676
20210304,부산,20,20,0,3302
20210304,서울,129,129,0,28819
20210304,합계,398,381,17,91637
20210303,검역,6,0,6,2992
20210303,제주,3,3,0,582
20210303,경남,10,9,1,2208
20210303,경북,7,5,2,3286
20210303,전남,1,1,0,872
20210303,전북,6,6,0,1221
20210303,충남,4,2,2,2460
20210303,충북,12,12,0,1801
20210303,강원,6,6,0,1883
20210303,경기,186,177,9,24242
20210303,세종,0,0,0,236
20210303,울산,0,0,0,1016
20210303,대전,3,3,0,1196
20210303,광주,6,6,0,2105
20210303,인천,18,18,0,4494
20210303,대구,20,19,1,8673
20210303,부산,18,17,1,3282
20210303,서울,118,117,1,28690
20210303,합계,424,401,23,91239
20210302,검역,2,0,2,2986
20210302,제주,4,4,0,579
20210302,경남,5,4,1,2198
20210302,경북,6,5,1,3279
20210302,전남,3,3,0,871
20210302,전북,5,5,0,1215
20210302,충남,4,4,0,2456
20210302,충북,19,19,0,1789
20210302,강원,6,6,0,1877
20210302,경기,227,218,9,24056
20210302,세종,4,4,0,236
20210302,울산,1,1,0,1016
20210302,대전,2,2,0,1193
20210302,광주,3,3,0,2099
20210302,인천,20,19,1,4476
20210302,대구,6,5,1,8653
20210302,부산,8,8,0,3264
20210302,서울,119,116,3,28572
20210302,합계,444,426,18,90815
20210301,검역,9,0,9,2984
20210301,제주,5,5,0,575
20210301,경남,5,3,2,2193
20210301,경북,7,4,3,3273
20210301,전남,7,7,0,868
20210301,전북,9,9,0,1210
20210301,충남,4,4,0,2452
20210301,충북,6,5,1,1770
20210301,강원,2,2,0,1871
20210301,경기,116,111,5,23829
20210301,세종,5,5,0,232
20210301,울산,0,0,0,1015
20210301,대전,1,1,0,1191
20210301,광주,4,4,0,2096
20210301,인천,11,10,1,4456
20210301,대구,14,12,2,8647
20210301,부산,17,17,0,3256
20210301,서울,122,120,2,28454
20210301,합계,344,319,25,90372
20210228,검역,5,0,5,2975
20210228,제주,0,0,0,570
20210228,경남,5,4,1,2188
20210228,경북,13,10,3,3266
20210228,전남,2,2,0,861
20210228,전북,10,10,0,1201
20210228,충남,4,2,2,2448
20210228,충북,8,8,0,1764
20210228,강원,5,5,0,1869
20210228,경기,159,156,4,23714
20210228,세종,1,1,0,227
20210228,울산,2,2,0,1015
20210228,대전,0,0,0,1190
20210228,광주,8,6,2,2092
20210228,인천,14,14,0,4445
20210228,대구,10,10,0,8633
20210228,부산,16,16,0,3239
20210228,서울,92,92,0,28331
20210228,합계,355,338,17,90028
20210227,검역,9,0,9,2970
20210227,제주,1,1,0,570
20210227,경남,2,2,0,2183
20210227,경북,4,3,1,3253
20210227,전남,0,0,0,859
20210227,전북,7,7,0,1191
20210227,충남,7,4,3,2444
20210227,충북,10,10,0,1756
20210227,강원,4,3,1,1864
20210227,경기,141,138,3,23553
20210227,세종,6,6,0,226
20210227,울산,5,5,0,1013
20210227,대전,1,1,0,1190
20210227,광주,14,14,0,2084
20210227,인천,13,13,0,4431
20210227,대구,6,5,1,8623
20210227,부산,5,4,1,3223
20210227,서울,120,117,3,28239
20210227,합계,355,333,22,89674
20210226,검역,3,0,3,2961
20210226,제주,1,1,0,569
20210226,경남,1,1,0,2181
20210226,경북,7,6,1,3249
20210226,전남,5,4,1,859
20210226,전북,20,20,0,1184
20210226,충남,4,4,0,2437
20210226,충북,8,8,0,1746
20210226,강원,6,5,1,1860
20210226,경기,169,166,3,23412
20210226,세종,1,1,0,220
20210226,울산,3,3,0,1008
20210226,대전,2,2,0,1189
20210226,광주,12,12,0,2070
20210226,인천,27,27,0,4418
20210226,대구,6,6,0,8617
20210226,부산,9,9,0,3218
20210226,서울,131,130,1,28119
20210226,합계,415,405,10,89317
20210225,검역,8,0,8,2958
20210225,제주,0,0,0,568
20210225,경남,6,5,1,2180
20210225,경북,6,5,1,3242
20210225,전남,5,5,0,854
20210225,전북,16,15,1,1164
20210225,충남,3,2,1,2433
20210225,충북,10,10,0,1738
20210225,강원,6,5,1,1854
20210225,경기,141,135,6,23243
20210225,세종,1,1,0,219
20210225,울산,1,1,0,1005
20210225,대전,6,6,0,1187
20210225,광주,11,11,0,2058
20210225,인천,15,14,1,4391
20210225,대구,10,10,0,8612
20210225,부산,11,10,1,3209
20210225,서울,131,128,3,27988
20210225,합계,387,363,24,88903
20210224,검역,10,0,10,2950
20210224,제주,5,5,0,568
20210224,경남,2,2,0,2174
20210224,경북,9,9,0,3236
20210224,전남,11,11,0,849
20210224,전북,5,5,0,1148
20210224,충남,16,16,0,2430
20210224,충북,4,4,0,1728
20210224,강원,2,2,0,1848
20210224,경기,138,132,6,23102
20210224,세종,0,0,0,218
20210224,울산,2,1,1,1004
20210224,대전,0,0,0,1181
20210224,광주,15,15,0,2047
20210224,인천,22,22,0,4376
20210224,대구,14,12,2,8601
20210224,부산,18,18,0,3198
20210224,서울,122,114,8,27857
20210224,합계,395,368,27,88515
20210223,검역,4,0,4,2940
20210223,제주,2,2,0,563
20210223,경남,8,7,1,2172
20210223,경북,18,15,3,3227
20210223,전남,1,1,0,838
20210223,전북,8,8,0,1143
20210223,충남,12,12,0,2414
20210223,충북,1,1,0,1724
20210223,강원,9,9,0,1846
20210223,경기,143,137,6,22964
20210223,세종,2,2,0,218
20210223,울산,1,1,0,1002
20210223,대전,2,2,0,1181
20210223,광주,35,35,0,2032
20210223,인천,18,17,1,4354
20210223,대구,19,17,2,8587
20210223,부산,13,13,0,3180
20210223,서울,144,138,6,27735
20210223,합계,440,417,23,88120
20210222,검역,5,0,5,2936
20210222,제주,0,0,0,561
20210222,경남,5,5,0,2164
20210222,경북,8,7,1,3209
20210222,전남,6,6,0,837
20210222,전북,7,7,0,1135
20210222,충남,8,8,0,2402
20210222,충북,4,4,0,1723
20210222,강원,14,14,0,1837
20210222,경기,127,122,5,22821
20210222,세종,1,1,0,216
20210222,울산,2,1,1,1001
20210222,대전,1,0,1,1179
20210222,광주,7,6,1,1997
20210222,인천,14,12,2,4336
20210222,대구,10,7,3,8568
20210222,부산,12,12,0,3167
20210222,서울,125,117,8,27591
20210222,합계,356,329,27,87680
20210221,검역,4,0,4,2931
20210221,제주,0,0,0,561
20210221,경남,6,5,1,2159
20210221,경북,11,11,0,3201
20210221,전남,3,3,0,831
20210221,전북,4,4,0,1128
20210221,충남,6,6,0,2394
20210221,충북,7,7,0,1719
20210221,강원,20,19,1,1823
20210221,경기,121,116,5,22694
20210221,세종,0,0,0,215
20210221,울산,1,0,1,999
20210221,대전,3,2,1,1178
20210221,광주,5,4,1,1990
20210221,인천,19,18,1,4322
20210221,대구,4,4,0,8558
20210221,부산,12,12,0,3155
20210221,서울,106,102,4,27466
20210221,합계,332,313,19,87324
20210220,검역,8,0,8,2927
20210220,제주,3,3,0,561
20210220,경남,7,7,0,2153
20210220,경북,7,6,1,3190
20210220,전남,8,8,0,828
20210220,전북,8,7,1,1124
20210220,충남,10,10,0,2388
20210220,충북,6,6,0,1712
20210220,강원,6,6,0,1803
20210220,경기,171,170,1,22573
20210220,세종,1,1,0,215
20210220,울산,4,4,0,998
20210220,대전,0,0,0,1175
20210220,광주,6,5,1,1985
20210220,인천,21,21,0,4303
20210220,대구,8,6,2,8554
20210220,부산,12,11,1,3143
20210220,서울,130,120,10,27360
20210220,합계,416,391,25,86992
20210219,검역,7,0,7,2919
20210219,제주,2,2,0,558
20210219,경남,8,8,0,2146
20210219,경북,19,16,3,3183
20210219,전남,10,10,0,820
20210219,전북,8,8,0,1116
20210219,충남,12,12,0,2378
20210219,충북,16,16,0,1706
20210219,강원,5,3,2,1797
20210219,경기,170,161,9,22402
20210219,세종,0,0,0,214
20210219,울산,1,0,1,994
20210219,대전,2,2,0,1175
20210219,광주,5,1,4,1979
20210219,인천,37,35,2,4282
20210219,대구,9,9,0,8546
20210219,부산,14,14,0,3131
20210219,서울,123,119,4,27230
20210219,합계,448,416,32,86576
20210218,검역,10,0,10,2912
20210218,제주,3,3,0,556
20210218,경남,9,9,0,2138
20210218,경북,22,22,0,3164
20210218,전남,10,10,0,810
20210218,전북,3,3,0,1108
20210218,충남,24,21,3,2366
20210218,충북,18,18,0,1690
20210218,강원,7,5,2,1792
20210218,경기,189,182,7,22232
20210218,세종,1,1,0,214
20210218,울산,12,12,0,993
20210218,대전,4,4,0,1173
20210218,광주,4,3,1,1974
20210218,인천,38,37,1,4245
20210218,대구,11,10,1,8537
20210218,부산,16,16,0,3117
20210218,서울,180,177,3,27107
20210218,합계,561,533,28,86128
20210217,검역,12,0,12,2902
20210217,제주,5,5,0,553
20210217,경남,7,7,0,2129
20210217,경북,23,22,1,3142
20210217,전남,4,4,0,800
20210217,전북,6,5,1,1105
20210217,충남,28,28,0,2342
20210217,충북,17,16,1,1672
20210217,강원,4,3,1,1785
20210217,경기,241,237,4,22043
20210217,세종,1,1,0,213
20210217,울산,6,6,0,981
20210217,대전,12,12,0,1169
20210217,광주,16,12,4,1970
20210217,인천,17,16,1,4207
20210217,대구,9,9,0,8526
20210217,부산,28,28,0,3101
20210217,서울,185,179,6,26927
20210217,합계,621,590,31,85567
20210216,검역,6,0,6,2890
20210216,제주,0,0,0,548
20210216,경남,8,7,1,2122
20210216,경북,15,14,1,3119
20210216,전남,15,15,0,796
20210216,전북,6,6,0,1099
20210216,충남,75,74,1,2314
20210216,충북,6,6,0,1655
20210216,강원,3,3,0,1781
20210216,경기,154,147,7,21802
20210216,세종,2,2,0,212
20210216,울산,9,9,0,975
20210216,대전,7,7,0,1157
20210216,광주,3,2,1,1954
20210216,인천,21,21,0,4190
20210216,대구,14,12,2,8517
20210216,부산,19,18,1,3073
20210216,서울,258,247,11,26742
20210216,합계,621,590,31,84946
20210215,검역,8,0,8,2884
20210215,제주,1,1,0,548
20210215,경남,8,6,2,2114
20210215,경북,3,2,1,3104
20210215,전남,2,2,0,781
20210215,전북,5,5,0,1093
20210215,충남,58,58,0,2239
20210215,충북,7,7,0,1649
20210215,강원,5,4,1,1778
20210215,경기,134,129,5,21648
20210215,세종,0,0,0,210
20210215,울산,7,7,0,966
20210215,대전,4,4,0,1150
20210215,광주,2,2,0,1951
20210215,인천,21,19,2,4169
20210215,대구,12,11,1,8503
20210215,부산,19,17,2,3054
20210215,서울,161,155,6,26484
20210215,합계,457,429,28,84325
20210214,검역,6,0,6,2876
20210214,제주,0,0,0,547
20210214,경남,3,3,0,2106
20210214,경북,8,8,0,3101
20210214,전남,5,4,1,779
20210214,전북,4,4,0,1088
20210214,충남,9,9,0,2181
20210214,충북,0,0,0,1642
20210214,강원,1,1,0,1773
20210214,경기,102,99,3,21514
20210214,세종,0,0,0,210
20210214,울산,4,3,1,959
20210214,대전,8,6,2,1146
20210214,광주,3,3,0,1949
20210214,인천,12,9,3,4148
20210214,대구,13,12,1,8491
20210214,부산,15,15,0,3035
20210214,서울,150,146,4,26323
20210214,합계,343,322,21,83868
20210213,검역,7,0,7,2870
20210213,제주,0,0,0,547
20210213,경남,6,6,0,2103
20210213,경북,5,4,1,3093
20210213,전남,2,1,1,774
20210213,전북,6,5,1,1084
20210213,충남,12,11,1,2172
20210213,충북,5,5,0,1642
20210213,강원,5,5,0,1772
20210213,경기,80,77,3,21412
20210213,세종,2,2,0,210
20210213,울산,3,3,0,955
20210213,대전,2,2,0,1138
20210213,광주,2,2,0,1946
20210213,인천,19,19,0,4136
20210213,대구,3,3,0,8478
20210213,부산,15,12,3,3020
20210213,서울,152,147,5,26173
20210213,합계,326,304,22,83525
20210212,검역,5,0,5,2863
20210212,제주,0,0,0,547
20210212,경남,4,4,0,2097
20210212,경북,5,4,1,3088
20210212,전남,0,0,0,772
20210212,전북,5,5,0,1078
20210212,충남,15,14,1,2160
20210212,충북,5,4,1,1637
20210212,강원,2,2,0,1767
20210212,경기,99,97,2,21332
20210212,세종,5,5,0,208
20210212,울산,2,2,0,952
20210212,대전,5,5,0,1136
20210212,광주,3,3,0,1944
20210212,인천,30,29,1,4117
20210212,대구,14,14,0,8475
20210212,부산,27,26,1,3005
20210212,서울,136,131,5,26021
20210212,합계,362,345,17,83199
20210211,검역,6,0,6,2858
20210211,제주,4,4,0,547
20210211,경남,4,4,0,2093
20210211,경북,4,4,0,3083
20210211,전남,4,4,0,772
20210211,전북,2,2,0,1073
20210211,충남,13,10,3,2145
20210211,충북,6,6,0,1632
20210211,강원,6,6,0,1765
20210211,경기,105,103,2,21233
20210211,세종,2,2,0,203
20210211,울산,0,0,0,950
20210211,대전,1,1,0,1131
20210211,광주,6,6,0,1941
20210211,인천,43,41,2,4087
20210211,대구,12,11,1,8461
20210211,부산,27,25,2,2978
20210211,서울,158,155,3,25885
20210211,합계,403,384,19,82837
20210210,검역,15,0,15,2852
20210210,제주,4,4,0,543
20210210,경남,5,5,0,2089
20210210,경북,1,1,0,3079
20210210,전남,0,0,0,768
20210210,전북,7,7,0,1071
20210210,충남,1,1,0,2132
20210210,충북,4,3,1,1626
20210210,강원,11,11,0,1759
20210210,경기,188,181,7,21128
20210210,세종,0,0,0,201
20210210,울산,2,2,0,950
20210210,대전,3,2,1,1130
20210210,광주,13,9,4,1935
20210210,인천,25,25,0,4044
20210210,대구,13,10,3,8449
20210210,부산,29,29,0,2951
20210210,서울,183,177,6,25727
20210210,합계,504,467,37,82434
20210209,검역,6,0,6,2837
20210209,제주,0,0,0,539
20210209,경남,9,9,0,2084
20210209,경북,2,2,0,3078
20210209,전남,2,1,1,768
20210209,전북,2,2,0,1064
20210209,충남,2,2,0,2131
20210209,충북,2,2,0,1622
20210209,강원,5,5,0,1748
20210209,경기,169,157,12,20940
20210209,세종,1,1,0,201
20210209,울산,0,0,0,948
20210209,대전,0,0,0,1127
20210209,광주,14,14,0,1922
20210209,인천,20,18,2,4019
20210209,대구,16,14,2,8436
20210209,부산,19,18,1,2922
20210209,서울,175,169,6,25544
20210209,합계,444,414,30,81930
20210208,검역,10,0,10,2831
20210208,제주,2,2,0,539
20210208,경남,7,5,2,2075
20210208,경북,5,4,1,3076
20210208,전남,0,0,0,766
20210208,전북,3,3,0,1062
20210208,충남,5,5,0,2129
20210208,충북,3,2,1,1620
20210208,강원,3,3,0,1743
20210208,경기,126,117,9,20771
20210208,세종,1,1,0,200
20210208,울산,3,3,0,948
20210208,대전,2,2,0,1127
20210208,광주,8,8,0,1908
20210208,인천,16,14,2,3999
20210208,대구,9,9,0,8420
20210208,부산,9,9,0,2903
20210208,서울,90,86,4,25369
20210208,합계,302,273,29,81486
20210207,검역,8,0,8,2820
20210207,제주,0,0,0,537
20210207,경남,4,4,0,2068
20210207,경북,6,5,1,3071
20210207,전남,0,0,0,766
20210207,전북,0,0,0,1059
20210207,충남,10,5,5,2124
20210207,충북,0,0,0,1617
20210207,강원,4,4,0,1740
20210207,경기,82,78,4,20645
20210207,세종,1,1,0,199
20210207,울산,1,0,1,945
20210207,대전,4,4,0,1125
20210207,광주,7,7,0,1900
20210207,인천,18,17,1,3983
20210207,대구,21,20,1,8411
20210207,부산,9,7,2,2894
20210207,서울,112,111,1,25279
20210207,합계,287,263,24,81183
20210206,검역,27,0,27,2812
20210206,제주,2,2,0,537
20210206,경남,4,4,0,2064
20210206,경북,1,1,0,3065
20210206,전남,4,4,0,766
20210206,전북,0,0,0,1059
20210206,충남,14,8,6,2114
20210206,충북,1,1,0,1617
20210206,강원,6,5,1,1736
20210206,경기,112,108,4,20562
20210206,세종,1,1,0,198
20210206,울산,1,0,1,944
20210206,대전,6,6,0,1121
20210206,광주,10,10,0,1893
20210206,인천,17,15,2,3965
20210206,대구,12,11,1,8390
20210206,부산,9,8,1,2885
20210206,서울,144,141,3,25167
20210206,합계,371,325,46,80895
20210205,검역,11,0,11,2785
20210205,제주,6,6,0,535
20210205,경남,12,10,2,2060
20210205,경북,7,4,3,3064
20210205,전남,1,1,0,762
20210205,전북,4,1,3,1059
20210205,충남,13,13,0,2100
20210205,충북,2,2,0,1616
20210205,강원,1,1,0,1730
20210205,경기,114,108,6,20450
20210205,세종,0,0,0,197
20210205,울산,2,2,0,943
20210205,대전,8,8,0,1115
20210205,광주,12,12,0,1883
20210205,인천,25,24,1,3948
20210205,대구,18,18,0,8378
20210205,부산,14,14,0,2876
20210205,서울,143,142,1,25023
20210205,합계,393,366,27,80524
20210204,검역,7,0,7,2774
20210204,제주,2,2,0,529
20210204,경남,6,6,0,2048
20210204,경북,7,6,1,3057
20210204,전남,0,0,0,761
20210204,전북,0,0,0,1055
20210204,충남,13,11,2,2087
20210204,충북,3,2,1,1614
20210204,강원,5,5,0,1729
20210204,경기,114,110,4,20336
20210204,세종,0,0,0,197
20210204,울산,0,0,0,941
20210204,대전,0,0,0,1107
20210204,광주,14,14,0,1871
20210204,인천,26,25,1,3923
20210204,대구,14,14,0,8360
20210204,부산,33,33,0,2862
20210204,서울,126,122,4,24880
20210204,합계,370,351,19,80131
20210203,검역,6,0,6,2767
20210203,제주,3,2,1,527
20210203,경남,8,7,1,2042
20210203,경북,6,6,0,3050
20210203,전남,2,2,0,761
20210203,전북,1,1,0,1055
20210203,충남,13,13,0,2074
20210203,충북,4,4,0,1611
20210203,강원,8,8,0,1724
20210203,경기,134,128,6,20222
20210203,세종,0,0,0,197
20210203,울산,2,2,0,941
20210203,대전,2,2,0,1107
20210203,광주,12,12,0,1857
20210203,인천,44,43,1,3897
20210203,대구,8,7,1,8346
20210203,부산,26,26,0,2829
20210203,서울,172,166,6,24754
20210203,합계,451,429,22,79761
20210202,검역,17,0,17,2761
20210202,제주,1,1,0,524
20210202,경남,8,8,0,2034
20210202,경북,12,10,2,3044
20210202,전남,6,6,0,759
20210202,전북,10,10,0,1054
20210202,충남,36,35,1,2061
20210202,충북,9,8,1,1607
20210202,강원,6,5,1,1716
20210202,경기,111,107,4,20088
20210202,세종,1,1,0,197
20210202,울산,0,0,0,939
20210202,대전,7,7,0,1105
20210202,광주,6,6,0,1845
20210202,인천,21,18,3,3853
20210202,대구,9,9,0,8338
20210202,부산,19,18,1,2803
20210202,서울,188,184,4,24582
20210202,합계,467,433,34,79310
20210201,검역,12,0,12,2744
20210201,제주,1,0,1,523
20210201,경남,11,9,2,2026
20210201,경북,10,10,0,3032
20210201,전남,3,2,1,753
20210201,전북,2,2,0,1044
20210201,충남,5,5,0,2025
20210201,충북,18,18,0,1598
20210201,강원,7,7,0,1710
20210201,경기,82,70,12,19977
20210201,세종,0,0,0,196
20210201,울산,1,0,1,939
20210201,대전,0,0,0,1098
20210201,광주,24,23,1,1839
20210201,인천,8,8,0,3832
20210201,대구,12,10,2,8329
20210201,부산,12,10,2,2784
20210201,서울,128,121,7,24394
20210201,합계,336,295,41,78843
20210131,검역,6,0,6,2732
20210131,제주,0,0,0,522
20210131,경남,4,4,0,2015
20210131,경북,5,4,1,3022
20210131,전남,1,0,1,750
20210131,전북,3,1,2,1042
20210131,충남,4,3,1,2020
20210131,충북,6,5,1,1580
20210131,강원,8,8,0,1703
20210131,경기,92,89,3,19895
20210131,세종,0,0,0,196
20210131,울산,1,0,1,938
20210131,대전,1,0,1,1098
20210131,광주,32,32,0,1815
20210131,인천,11,11,0,3824
20210131,대구,9,9,0,8317
20210131,부산,15,15,0,2772
20210131,서울,107,104,3,24266
20210131,합계,305,285,20,78507
20210130,검역,15,0,15,2726
20210130,제주,1,1,0,522
20210130,경남,18,18,0,2011
20210130,경북,16,15,1,3017
20210130,전남,1,1,0,749
20210130,전북,2,2,0,1039
20210130,충남,5,4,1,2016
20210130,충북,1,1,0,1574
20210130,강원,6,6,0,1695
20210130,경기,113,107,6,19803
20210130,세종,2,2,0,196
20210130,울산,6,6,0,937
20210130,대전,0,0,0,1097
20210130,광주,17,16,1,1783
20210130,인천,21,19,2,3813
20210130,대구,10,9,1,8308
20210130,부산,20,20,0,2757
20210130,서울,101,96,3,24160
20210130,합계,355,323,30,78203
20210129,검역,15,0,15,2711
20210129,제주,2,2,0,521
20210129,경남,12,11,1,1993
20210129,경북,22,21,1,3001
20210129,전남,1,1,0,748
20210129,전북,3,3,0,1037
20210129,충남,9,8,1,2011
20210129,충북,11,11,0,1573
20210129,강원,3,3,0,1689
20210129,경기,146,136,10,19690
20210129,세종,0,0,0,194
20210129,울산,2,1,1,931
20210129,대전,2,1,1,1097
20210129,광주,33,32,1,1766
20210129,인천,15,15,0,3792
20210129,대구,8,8,0,8298
20210129,부산,20,18,2,2737
20210129,서울,154,150,2,24061
20210129,합계,456,421,35,77848
20210128,검역,9,0,9,2698
20210128,제주,1,1,0,519
20210128,경남,15,15,0,1981
20210128,경북,43,41,2,2979
20210128,전남,5,5,0,747
20210128,전북,6,4,2,1034
20210128,충남,6,6,0,2002
20210128,충북,9,9,0,1562
20210128,강원,8,7,1,1686
20210128,경기,135,129,6,19544
20210128,세종,0,0,0,194
20210128,울산,2,2,0,929
20210128,대전,1,1,0,1095
20210128,광주,54,54,0,1733
20210128,인천,19,18,1,3777
20210128,대구,10,10,0,8290
20210128,부산,34,34,0,2717
20210128,서울,112,109,3,23908
20210128,합계,469,445,24,77395
20210127,검역,7,0,7,2689
20210127,제주,0,0,0,518
20210127,경남,19,19,0,1966
20210127,경북,43,43,0,2936
20210127,전남,8,8,0,742
20210127,전북,1,1,0,1028
20210127,충남,4,4,0,1996
20210127,충북,25,24,1,1553
20210127,강원,6,6,0,1678
20210127,경기,118,116,2,19408
20210127,세종,1,0,1,194
20210127,울산,6,5,1,927
20210127,대전,4,4,0,1094
20210127,광주,44,44,0,1679
20210127,인천,41,40,1,3758
20210127,대구,11,10,1,8280
20210127,부산,54,53,1,2683
20210127,서울,105,102,3,23797
20210127,합계,497,479,18,76926
20210126,검역,12,0,12,2682
20210126,제주,0,0,0,518
20210126,경남,21,20,1,1947
20210126,경북,11,10,1,2893
20210126,전남,12,12,0,734
20210126,전북,13,11,2,1027
20210126,충남,4,4,0,1992
20210126,충북,8,8,0,1528
20210126,강원,18,18,0,1672
20210126,경기,150,137,13,19290
20210126,세종,4,4,0,193
20210126,울산,6,5,1,921
20210126,대전,1,1,0,1090
20210126,광주,112,112,0,1635
20210126,인천,20,17,3,3717
20210126,대구,6,6,0,8269
20210126,부산,32,31,1,2629
20210126,서울,129,120,9,23692
20210126,합계,559,516,43,76429
20210125,검역,6,0,6,2670
20210125,제주,0,0,0,518
20210125,경남,12,12,0,1926
20210125,경북,8,8,0,2882
20210125,전남,9,9,0,722
20210125,전북,1,1,0,1014
20210125,충남,6,6,0,1988
20210125,충북,7,7,0,1520
20210125,강원,43,42,1,1654
20210125,경기,82,74,3,19141
20210125,세종,2,2,0,189
20210125,울산,0,0,0,915
20210125,대전,4,4,0,1089
20210125,광주,12,12,0,1523
20210125,인천,18,16,2,3697
20210125,대구,13,12,1,8263
20210125,부산,27,27,0,2597
20210125,서울,104,101,3,23563
20210125,합계,350,334,16,75871
20210124,검역,11,0,11,2664
20210124,제주,0,0,0,518
20210124,경남,11,11,0,1914
20210124,경북,15,14,1,2874
20210124,전남,3,3,0,713
20210124,전북,0,0,0,1013
20210124,충남,13,13,0,1982
20210124,충북,8,8,0,1513
20210124,강원,4,3,1,1611
20210124,경기,76,72,4,19063
20210124,세종,2,2,0,187
20210124,울산,2,2,0,915
20210124,대전,125,125,0,1085
20210124,광주,16,15,1,1511
20210124,인천,14,13,1,3679
20210124,대구,15,14,1,8250
20210124,부산,20,19,1,2570
20210124,서울,102,91,11,23459
20210124,합계,437,405,32,75521
20210123,검역,9,0,9,2653
20210123,제주,2,1,1,518
20210123,경남,17,17,0,1903
20210123,경북,8,7,1,2859
20210123,전남,1,1,0,710
20210123,전북,4,3,1,1013
20210123,충남,9,9,0,1969
20210123,충북,12,12,0,1505
20210123,강원,11,11,0,1607
20210123,경기,99,99,0,18987
20210123,세종,11,11,0,185
20210123,울산,2,1,1,913
20210123,대전,0,0,0,960
20210123,광주,17,17,0,1495
20210123,인천,25,23,2,3665
20210123,대구,12,11,1,8235
20210123,부산,20,19,1,2550
20210123,서울,133,127,6,23357
20210123,합계,392,369,23,75084
20210122,검역,12,0,12,2644
20210122,제주,3,3,0,516
20210122,경남,32,32,0,1886
20210122,경북,18,18,0,2851
20210122,전남,10,9,1,709
20210122,전북,7,7,0,1009
20210122,충남,17,17,0,1960
20210122,충북,4,4,0,1493
20210122,강원,6,5,1,1596
20210122,경기,117,113,4,18888
20210122,세종,1,1,0,174
20210122,울산,2,2,0,911
20210122,대전,1,1,0,960
20210122,광주,7,6,1,1478
20210122,인천,12,12,0,3640
20210122,대구,22,21,1,8223
20210122,부산,33,33,0,2530
20210122,서울,127,119,8,23224
20210122,합계,431,403,28,74692
20210121,검역,9,0,9,2633
20210121,제주,2,2,0,513
20210121,경남,21,21,0,1854
20210121,경북,15,12,3,2833
20210121,전남,7,7,0,699
20210121,전북,0,0,0,1002
20210121,충남,7,7,0,1943
20210121,충북,1,1,0,1489
20210121,강원,9,8,1,1590
20210121,경기,116,102,14,18771
20210121,세종,0,0,0,173
20210121,울산,3,2,1,909
20210121,대전,1,1,0,959
20210121,광주,2,2,0,1471
20210121,인천,9,8,1,3628
20210121,대구,6,5,1,8201
20210121,부산,23,23,0,2497
20210121,서울,115,113,2,23097
20210121,합계,346,314,32,74262
20210120,검역,6,0,6,2624
20210120,제주,5,5,0,511
20210120,경남,16,15,1,1833
20210120,경북,8,8,0,2818
20210120,전남,14,14,0,692
20210120,전북,5,4,1,1002
20210120,충남,10,10,0,1936
20210120,충북,7,7,0,1488
20210120,강원,8,6,2,1581
20210120,경기,138,133,5,18655
20210120,세종,1,1,0,173
20210120,울산,3,2,1,906
20210120,대전,0,0,0,958
20210120,광주,6,5,1,1469
20210120,인천,23,22,1,3619
20210120,대구,7,7,0,8195
20210120,부산,19,19,0,2474
20210120,서울,125,122,3,22984
20210120,합계,401,380,21,73918
20210119,검역,1,0,1,2619
20210119,제주,6,6,0,506
20210119,경남,19,18,1,1817
20210119,경북,7,7,0,2810
20210119,전남,9,9,0,678
20210119,전북,2,2,0,997
20210119,충남,8,7,1,1926
20210119,충북,3,2,1,1481
20210119,강원,11,9,2,1573
20210119,경기,139,126,13,18517
20210119,세종,0,0,0,172
20210119,울산,3,3,0,903
20210119,대전,1,1,0,958
20210119,광주,11,11,0,1463
20210119,인천,16,14,2,3596
20210119,대구,12,11,1,8188
20210119,부산,13,12,1,2455
20210119,서울,143,135,8,22859
20210119,합계,404,373,31,73518
20210118,검역,8,0,8,2618
20210118,제주,1,1,0,500
20210118,경남,11,11,0,1798
20210118,경북,9,8,1,2803
20210118,전남,6,6,0,669
20210118,전북,3,2,1,995
20210118,충남,8,7,1,1918
20210118,충북,5,5,0,1478
20210118,강원,17,16,1,1562
20210118,경기,139,128,11,18378
20210118,세종,3,3,0,172
20210118,울산,8,5,3,900
20210118,대전,7,7,0,957
20210118,광주,8,7,1,1452
20210118,인천,19,18,1,3580
20210118,대구,16,15,1,8176
20210118,부산,17,17,0,2442
20210118,서울,101,95,6,22717
20210118,합계,386,351,35,73115
20210117,검역,10,0,10,2610
20210117,제주,2,2,0,499
20210117,경남,22,20,2,1787
20210117,경북,18,18,0,2794
20210117,전남,4,4,0,663
20210117,전북,3,3,0,992
20210117,충남,11,11,0,1910
20210117,충북,9,8,1,1473
20210117,강원,16,14,2,1545
20210117,경기,105,103,2,18239
20210117,세종,2,2,0,169
20210117,울산,6,5,1,892
20210117,대전,2,2,0,950
20210117,광주,11,11,0,1444
20210117,인천,13,13,0,3561
20210117,대구,13,13,0,8160
20210117,부산,10,9,1,2425
20210117,서울,132,128,4,22616
20210117,합계,389,366,23,72729
20210116,검역,8,0,8,2600
20210116,제주,0,0,0,497
20210116,경남,18,18,0,1765
20210116,경북,15,15,0,2776
20210116,전남,15,15,0,659
20210116,전북,5,5,0,989
20210116,충남,7,6,1,1899
20210116,충북,7,7,0,1464
20210116,강원,4,4,0,1529
20210116,경기,175,173,2,18134
20210116,세종,1,1,0,167
20210116,울산,18,15,3,886
20210116,대전,3,3,0,948
20210116,광주,15,14,1,1433
20210116,인천,35,35,0,3548
20210116,대구,15,15,0,8147
20210116,부산,34,32,2,2415
20210116,서울,145,142,3,22484
20210116,합계,520,500,20,72340
20210115,검역,8,0,8,2592
20210115,제주,4,4,0,497
20210115,경남,20,15,5,1747
20210115,경북,20,19,1,2761
20210115,전남,13,13,0,644
20210115,전북,17,17,0,984
20210115,충남,8,8,0,1892
20210115,충북,6,6,0,1457
20210115,강원,23,22,1,1525
20210115,경기,168,163,5,17959
20210115,세종,1,1,0,166
20210115,울산,8,8,0,868
20210115,대전,5,5,0,945
20210115,광주,6,6,0,1418
20210115,인천,33,30,3,3513
20210115,대구,23,23,0,8132
20210115,부산,61,59,2,2381
20210115,서울,156,148,8,22339
20210115,합계,580,547,33,71820
20210114,검역,5,0,5,2584
20210114,제주,1,1,0,493
20210114,경남,22,21,1,1727
20210114,경북,23,21,2,2741
20210114,전남,14,14,0,632
20210114,전북,6,6,0,967
20210114,충남,6,3,3,1884
20210114,충북,9,7,2,1451
20210114,강원,13,13,0,1502
20210114,경기,186,180,6,17791
20210114,세종,4,4,0,165
20210114,울산,6,6,0,860
20210114,대전,3,3,0,940
20210114,광주,6,5,1,1412
20210114,인천,24,23,1,3480
20210114,대구,11,10,1,8109
20210114,부산,47,45,2,2320
20210114,서울,127,122,5,22183
20210114,합계,513,484,29,71241
20210113,검역,11,0,11,2579
20210113,제주,2,2,0,492
20210113,경남,16,16,0,1705
20210113,경북,18,16,2,2718
20210113,전남,6,6,0,618
20210113,전북,3,3,0,961
20210113,충남,12,12,0,1878
20210113,충북,18,18,0,1442
20210113,강원,11,11,0,1489
20210113,경기,171,162,9,17605
20210113,세종,2,2,0,161
20210113,울산,10,9,1,854
20210113,대전,3,3,0,937
20210113,광주,31,30,1,1406
20210113,인천,25,24,1,3456
20210113,대구,11,11,0,8098
20210113,부산,40,40,0,2273
20210113,서울,134,131,3,22056
20210113,합계,524,496,28,70728
20210112,검역,3,0,3,2568
20210112,제주,1,1,0,490
20210112,경남,42,42,0,1689
20210112,경북,24,23,1,2701
20210112,전남,0,0,0,612
20210112,전북,8,7,1,958
20210112,충남,5,4,1,1866
20210112,충북,11,11,0,1424
20210112,강원,21,20,1,1478
20210112,경기,201,189,12,17434
20210112,세종,0,0,0,159
20210112,울산,11,11,0,844
20210112,대전,9,9,0,934
20210112,광주,4,3,1,1375
20210112,인천,22,20,2,3431
20210112,대구,13,13,0,8094
20210112,부산,35,35,0,2233
20210112,서울,152,148,4,21922
20210112,합계,562,536,26,70212
20210111,검역,8,0,8,2565
20210111,제주,2,2,0,489
20210111,경남,55,55,0,1647
20210111,경북,8,8,0,2677
20210111,전남,2,2,0,612
20210111,전북,12,11,1,950
20210111,충남,3,1,2,1861
20210111,충북,16,16,0,1413
20210111,강원,7,7,0,1457
20210111,경기,175,163,12,17233
20210111,세종,1,1,0,159
20210111,울산,7,7,0,833
20210111,대전,7,7,0,925
20210111,광주,7,7,0,1371
20210111,인천,21,20,1,3409
20210111,대구,18,17,1,8081
20210111,부산,21,21,0,2198
20210111,서울,167,163,4,21771
20210111,합계,537,508,29,69651
20210110,검역,11,0,11,2557
20210110,제주,2,2,0,487
20210110,경남,13,13,0,1592
20210110,경북,4,4,0,2669
20210110,전남,3,3,0,610
20210110,전북,7,6,1,938
20210110,충남,11,10,1,1858
20210110,충북,10,9,1,1397
20210110,강원,11,10,1,1450
20210110,경기,147,142,5,17058
20210110,세종,0,0,0,158
20210110,울산,14,14,0,826
20210110,대전,1,1,0,918
20210110,광주,24,24,0,1364
20210110,인천,22,18,4,3388
20210110,대구,11,10,1,8063
20210110,부산,19,16,3,2177
20210110,서울,141,137,4,21604
20210110,합계,451,419,32,69114
20210109,검역,14,0,14,2546
20210109,제주,4,4,0,485
20210109,경남,19,19,0,1579
20210109,경북,19,19,0,2665
20210109,전남,4,3,1,607
20210109,전북,6,6,0,931
20210109,충남,30,30,0,1847
20210109,충북,9,8,1,1387
20210109,강원,20,20,0,1439
20210109,경기,193,189,4,16912
20210109,세종,0,0,0,158
20210109,울산,34,34,0,812
20210109,대전,4,4,0,917
20210109,광주,21,18,3,1340
20210109,인천,33,32,1,3366
20210109,대구,34,34,0,8052
20210109,부산,34,32,2,2158
20210109,서울,187,179,8,21463
20210109,합계,665,631,34,68664
20210108,검역,10,0,10,2532
20210108,제주,5,5,0,481
20210108,경남,26,23,3,1560
20210108,경북,21,20,1,2646
20210108,전남,5,5,0,603
20210108,전북,14,13,1,925
20210108,충남,27,26,1,1817
20210108,충북,30,30,0,1378
20210108,강원,6,5,1,1419
20210108,경기,211,195,16,16719
20210108,세종,0,0,0,158
20210108,울산,8,8,0,778
20210108,대전,5,5,0,913
20210108,광주,6,6,0,1319
20210108,인천,49,46,3,3333
20210108,대구,13,12,1,8018
20210108,부산,17,17,0,2124
20210108,서울,188,180,8,21276
20210108,합계,641,596,45,67999
20210107,검역,6,0,6,2522
20210107,제주,6,6,0,476
20210107,경남,22,19,3,1534
20210107,경북,30,28,2,2625
20210107,전남,0,0,0,598
20210107,전북,8,7,1,911
20210107,충남,21,21,0,1790
20210107,충북,10,10,0,1348
20210107,강원,11,11,0,1413
20210107,경기,258,236,22,16508
20210107,세종,0,0,0,158
20210107,울산,10,10,0,770
20210107,대전,8,8,0,908
20210107,광주,21,21,0,1313
20210107,인천,30,30,0,3284
20210107,대구,18,17,1,8005
20210107,부산,24,22,2,2107
20210107,서울,191,186,5,21088
20210107,합계,674,632,42,67358
20210106,검역,14,0,14,2516
20210106,제주,9,9,0,470
20210106,경남,20,20,0,1512
20210106,경북,36,34,2,2595
20210106,전남,1,0,1,598
20210106,전북,2,2,0,903
20210106,충남,20,19,1,1769
20210106,충북,14,14,0,1338
20210106,강원,30,30,0,1402
20210106,경기,303,294,9,16250
20210106,세종,3,3,0,158
20210106,울산,9,9,0,760
20210106,대전,9,9,0,900
20210106,광주,28,28,0,1292
20210106,인천,41,37,4,3254
20210106,대구,10,10,0,7987
20210106,부산,23,23,0,2083
20210106,서울,298,292,6,20899
20210106,합계,870,833,37,66686
20210105,검역,6,0,6,2502
20210105,제주,5,5,0,461
20210105,경남,29,26,3,1492
20210105,경북,28,28,0,2559
20210105,전남,1,1,0,597
20210105,전북,22,22,0,901
20210105,충남,24,23,1,1749
20210105,충북,21,21,0,1324
20210105,강원,16,16,0,1372
20210105,경기,284,269,15,15947
20210105,세종,1,1,0,155
20210105,울산,2,2,0,751
20210105,대전,9,8,1,891
20210105,광주,30,30,0,1264
20210105,인천,38,35,3,3213
20210105,대구,22,21,1,7978
20210105,부산,38,38,0,2060
20210105,서울,264,263,1,20602
20210105,합계,840,809,31,65818
20210104,검역,16,0,16,2497
20210104,제주,8,8,0,456
20210104,경남,21,21,0,1463
20210104,경북,24,24,0,2531
20210104,전남,4,4,0,596
20210104,전북,5,4,1,879
20210104,충남,18,18,0,1725
20210104,충북,32,32,0,1303
20210104,강원,27,27,0,1356
20210104,경기,230,214,16,15663
20210104,세종,0,0,0,154
20210104,울산,4,4,0,749
20210104,대전,8,7,1,882
20210104,광주,23,23,0,1234
20210104,인천,49,48,1,3175
20210104,대구,32,31,1,7956
20210104,부산,15,14,1,2022
20210104,서울,199,193,6,20338
20210104,합계,715,672,43,64979
20210103,검역,11,0,11,2481
20210103,제주,10,9,1,448
20210103,경남,33,33,0,1442
20210103,경북,25,25,0,2507
20210103,전남,3,3,0,592
20210103,전북,13,9,4,874
20210103,충남,23,22,1,1707
20210103,충북,23,23,0,1271
20210103,강원,28,28,0,1329
20210103,경기,268,260,8,15434
20210103,세종,0,0,0,154
20210103,울산,5,5,0,745
20210103,대전,6,6,0,874
20210103,광주,74,74,0,1211
20210103,인천,103,101,2,3126
20210103,대구,29,29,0,7924
20210103,부산,37,34,3,2007
20210103,서울,329,324,5,20138
20210103,합계,1020,985,35,64264
20210102,검역,8,0,8,2470
20210102,제주,4,4,0,438
20210102,경남,12,12,0,1409
20210102,경북,14,14,0,2482
20210102,전남,12,12,0,589
20210102,전북,5,5,0,861
20210102,충남,9,9,0,1684
20210102,충북,27,26,1,1248
20210102,강원,33,33,0,1301
20210102,경기,205,201,4,15166
20210102,세종,1,1,0,154
20210102,울산,7,7,0,740
20210102,대전,8,8,0,868
20210102,광주,26,26,0,1137
20210102,인천,48,48,0,3023
20210102,대구,22,21,1,7895
20210102,부산,19,19,0,1970
20210102,서울,197,195,2,19809
20210102,합계,657,641,16,63244
20210101,검역,14,0,14,2462
20210101,제주,13,12,1,434
20210101,경남,37,35,2,1397
20210101,경북,20,18,2,2468
20210101,전남,11,9,2,577
20210101,전북,11,11,0,856
20210101,충남,7,6,1,1675
20210101,충북,36,34,2,1221
20210101,강원,31,31,0,1268
20210101,경기,227,221,6,14962
20210101,세종,3,3,0,153
20210101,울산,17,17,0,733
20210101,대전,4,4,0,860
20210101,광주,13,13,0,1111
20210101,인천,71,70,1,2975
20210101,대구,29,29,0,7873
20210101,부산,26,26,0,1951
20210101,서울,250,245,5,19613
20210101,합계,824,788,36,62593
20201231,검역,4,0,4,2448
20201231,제주,5,5,0,421
20201231,경남,35,34,1,1360
20201231,경북,24,24,0,2448
20201231,전남,6,6,0,566
20201231,전북,8,8,0,845
20201231,충남,15,15,0,1668
20201231,충북,22,22,0,1185
20201231,강원,30,29,1,1237
20201231,경기,284,271,13,14735
20201231,세종,1,1,0,150
20201231,울산,43,43,0,716
20201231,대전,11,11,0,856
20201231,광주,17,16,1,1098
20201231,인천,65,63,2,2904
20201231,대구,43,43,0,7844
20201231,부산,57,55,2,1925
20201231,서울,358,357,1,19362
20201231,합계,1027,1002,25,61754
