기준일,지역명,당일확진자,지역확진,해외확진,누적확진자
2021-07-13,검역,19,0,19,4593
2021-07-13,제주,21,21,0,1433
2021-07-13,경남,89,87,2,5661
2021-07-13,경북,22,19,3,5085
2021-07-13,전남,6,6,0,1744
2021-07-13,전북,9,9,0,2463
2021-07-13,충남,36,36,0,4218
2021-07-13,충북,10,9,1,3416
2021-07-13,강원,16,15,1,3770
2021-07-13,경기,465,453,12,48636
2021-07-13,세종,6,6,0,617
2021-07-13,울산,11,11,0,2959
2021-07-13,대전,41,41,0,3046
2021-07-13,광주,15,15,0,3062
2021-07-13,인천,96,93,3,7495
2021-07-13,대구,52,52,0,10850
2021-07-13,부산,63,62,1,6810
2021-07-13,서울,638,633,5,56053
2021-07-13,합계,1615,1568,47,171911
2021-07-12,검역,29,0,29,4574
2021-07-12,제주,19,19,0,1412
2021-07-12,경남,51,49,2,5572
2021-07-12,경북,8,8,0,5063
2021-07-12,전남,13,13,0,1738
2021-07-12,전북,18,18,0,2454
2021-07-12,충남,36,32,4,4182
2021-07-12,충북,8,7,1,3406
2021-07-12,강원,19,19,0,3754
2021-07-12,경기,318,313,5,48171
2021-07-12,세종,8,8,0,611
2021-07-12,울산,7,7,0,2948
2021-07-12,대전,31,31,0,3005
2021-07-12,광주,9,9,0,3047
2021-07-12,인천,71,67,4,7399
2021-07-12,대구,38,36,2,10798
2021-07-12,부산,50,47,3,6747
2021-07-12,서울,417,414,3,55415
2021-07-12,합계,1150,1097,53,170296
2021-07-11,검역,20,0,20,4545
2021-07-11,제주,7,7,0,1393
2021-07-11,경남,40,40,0,5521
2021-07-11,경북,13,12,1,5055
2021-07-11,전남,19,19,0,1725
2021-07-11,전북,4,4,0,2436
2021-07-11,충남,45,43,2,4146
2021-07-11,충북,14,13,1,3398
2021-07-11,강원,18,18,0,3735
2021-07-11,경기,327,322,5,47853
2021-07-11,세종,6,6,0,603
2021-07-11,울산,8,8,0,2941
2021-07-11,대전,25,25,0,2974
2021-07-11,광주,14,13,1,3038
2021-07-11,인천,56,51,5,7328
2021-07-11,대구,37,37,0,10760
2021-07-11,부산,44,43,1,6697
2021-07-11,서울,403,402,1,54998
2021-07-11,합계,1100,1063,37,169146
2021-07-10,검역,12,0,12,4525
2021-07-10,제주,24,24,0,1386
2021-07-10,경남,67,63,4,5481
2021-07-10,경북,12,10,2,5042
2021-07-10,전남,6,5,1,1706
2021-07-10,전북,2,2,0,2432
2021-07-10,충남,32,31,1,4101
2021-07-10,충북,8,7,1,3384
2021-07-10,강원,20,20,0,3717
2021-07-10,경기,407,399,8,47526
2021-07-10,세종,3,3,0,597
2021-07-10,울산,22,22,0,2933
2021-07-10,대전,32,31,1,2949
2021-07-10,광주,23,22,1,3024
2021-07-10,인천,66,64,2,7272
2021-07-10,대구,23,23,0,10723
2021-07-10,부산,56,53,3,6653
2021-07-10,서울,509,501,8,54595
2021-07-10,합계,1324,1280,44,168046
2021-07-09,검역,21,0,21,4513
2021-07-09,제주,10,10,0,1362
2021-07-09,경남,36,36,0,5414
2021-07-09,경북,13,9,4,5030
2021-07-09,전남,2,2,0,1700
2021-07-09,전북,14,14,0,2430
2021-07-09,충남,29,28,1,4069
2021-07-09,충북,19,18,1,3376
2021-07-09,강원,16,15,1,3697
2021-07-09,경기,451,441,10,47119
2021-07-09,세종,0,0,0,594
2021-07-09,울산,30,29,1,2911
2021-07-09,대전,48,47,1,2917
2021-07-09,광주,21,20,1,3001
2021-07-09,인천,84,79,5,7206
2021-07-09,대구,14,12,2,10700
2021-07-09,부산,61,59,2,6597
2021-07-09,서울,509,501,8,54086
2021-07-09,합계,1378,1320,58,166722
2021-07-08,검역,39,0,39,4492
2021-07-08,제주,31,30,1,1352
2021-07-08,경남,17,17,0,5378
2021-07-08,경북,9,9,0,5017
2021-07-08,전남,5,5,0,1698
2021-07-08,전북,8,8,0,2416
2021-07-08,충남,52,51,1,4040
2021-07-08,충북,14,13,1,3357
2021-07-08,강원,24,23,1,3681
2021-07-08,경기,405,396,9,46668
2021-07-08,세종,1,1,0,594
2021-07-08,울산,16,16,0,2881
2021-07-08,대전,29,28,1,2869
2021-07-08,광주,4,3,1,2980
2021-07-08,인천,82,72,10,7122
2021-07-08,대구,19,16,3,10686
2021-07-08,부산,58,53,5,6536
2021-07-08,서울,503,495,8,53577
2021-07-08,합계,1316,1236,80,165344
2021-07-07,검역,25,0,25,4453
2021-07-07,제주,17,17,0,1321
2021-07-07,경남,10,7,3,5361
2021-07-07,경북,4,4,0,5008
2021-07-07,전남,9,7,2,1693
2021-07-07,전북,3,3,0,2408
2021-07-07,충남,78,77,1,3988
2021-07-07,충북,8,8,0,3343
2021-07-07,강원,16,15,1,3657
2021-07-07,경기,392,388,4,46263
2021-07-07,세종,5,4,1,593
2021-07-07,울산,9,8,1,2865
2021-07-07,대전,13,12,1,2840
2021-07-07,광주,2,2,0,2976
2021-07-07,인천,64,61,3,7040
2021-07-07,대구,15,14,1,10667
2021-07-07,부산,55,55,0,6478
2021-07-07,서울,550,545,5,53074
2021-07-07,합계,1275,1227,48,164028
2021-07-06,검역,20,0,20,4428
2021-07-06,제주,19,18,1,1304
2021-07-06,경남,15,15,0,5351
2021-07-06,경북,6,4,2,5004
2021-07-06,전남,10,10,0,1684
2021-07-06,전북,8,8,0,2405
2021-07-06,충남,16,16,0,3910
2021-07-06,충북,5,5,0,3335
2021-07-06,강원,12,12,0,3641
2021-07-06,경기,367,357,10,45871
2021-07-06,세종,5,5,0,588
2021-07-06,울산,1,1,0,2856
2021-07-06,대전,30,29,1,2827
2021-07-06,광주,11,10,1,2974
2021-07-06,인천,57,56,1,6976
2021-07-06,대구,13,12,1,10652
2021-07-06,부산,34,33,1,6423
2021-07-06,서울,583,577,6,52524
2021-07-06,합계,1212,1168,44,162753
2021-07-05,검역,30,0,30,4408
2021-07-05,제주,5,4,1,1285
2021-07-05,경남,19,17,2,5336
2021-07-05,경북,11,11,0,4998
2021-07-05,전남,4,4,0,1674
2021-07-05,전북,6,6,0,2397
2021-07-05,충남,13,11,2,3894
2021-07-05,충북,2,2,0,3330
2021-07-05,강원,9,6,3,3629
2021-07-05,경기,229,224,5,45504
2021-07-05,세종,5,5,0,583
2021-07-05,울산,3,3,0,2855
2021-07-05,대전,26,26,0,2797
2021-07-05,광주,4,4,0,2963
2021-07-05,인천,23,20,3,6919
2021-07-05,대구,8,7,1,10639
2021-07-05,부산,29,27,2,6389
2021-07-05,서울,320,313,7,51941
2021-07-05,합계,746,690,56,161541
2021-07-04,검역,25,0,25,4378
2021-07-04,제주,6,5,1,1280
2021-07-04,경남,22,20,2,5317
2021-07-04,경북,13,10,3,4987
2021-07-04,전남,6,3,3,1670
2021-07-04,전북,6,6,0,2391
2021-07-04,충남,12,10,2,3881
2021-07-04,충북,3,3,0,3328
2021-07-04,강원,7,7,0,3620
2021-07-04,경기,220,210,10,45275
2021-07-04,세종,4,4,0,578
2021-07-04,울산,1,1,0,2852
2021-07-04,대전,19,18,1,2771
2021-07-04,광주,7,6,1,2959
2021-07-04,인천,22,16,6,6896
2021-07-04,대구,6,4,2,10631
2021-07-04,부산,25,20,5,6360
2021-07-04,서울,307,301,6,51621
2021-07-04,합계,711,644,67,160795
2021-07-03,검역,50,0,50,4353
2021-07-03,제주,2,2,0,1274
2021-07-03,경남,15,14,1,5295
2021-07-03,경북,9,8,1,4974
2021-07-03,전남,0,0,0,1664
2021-07-03,전북,3,2,1,2385
2021-07-03,충남,7,7,0,3869
2021-07-03,충북,2,2,0,3325
2021-07-03,강원,19,11,8,3613
2021-07-03,경기,231,227,4,45055
2021-07-03,세종,4,4,0,574
2021-07-03,울산,13,10,3,2851
2021-07-03,대전,32,32,0,2752
2021-07-03,광주,3,1,2,2952
2021-07-03,인천,33,28,5,6874
2021-07-03,대구,3,2,1,10625
2021-07-03,부산,28,26,2,6335
2021-07-03,서울,289,286,3,51314
2021-07-03,합계,743,662,81,160084
2021-07-02,검역,23,0,23,4303
2021-07-02,제주,4,4,0,1272
2021-07-02,경남,10,8,2,5280
2021-07-02,경북,4,3,1,4965
2021-07-02,전남,7,6,1,1664
2021-07-02,전북,4,4,0,2382
2021-07-02,충남,16,16,0,3862
2021-07-02,충북,6,5,1,3323
2021-07-02,강원,11,11,0,3594
2021-07-02,경기,252,247,5,44824
2021-07-02,세종,3,3,0,570
2021-07-02,울산,1,0,1,2838
2021-07-02,대전,28,28,0,2720
2021-07-02,광주,3,3,0,2949
2021-07-02,인천,16,14,2,6841
2021-07-02,대구,8,8,0,10622
2021-07-02,부산,39,35,4,6307
2021-07-02,서울,359,353,6,51026
2021-07-02,합계,794,748,46,159342
2021-07-01,검역,33,0,33,4280
2021-07-01,제주,3,3,0,1268
2021-07-01,경남,13,12,1,5270
2021-07-01,경북,7,7,0,4961
2021-07-01,전남,4,4,0,1657
2021-07-01,전북,7,7,0,2378
2021-07-01,충남,27,27,0,3846
2021-07-01,충북,7,7,0,3317
2021-07-01,강원,14,7,7,3583
2021-07-01,경기,264,260,4,44572
2021-07-01,세종,2,2,0,567
2021-07-01,울산,11,10,1,2837
2021-07-01,대전,25,25,0,2692
2021-07-01,광주,2,2,0,2946
2021-07-01,인천,22,22,0,6825
2021-07-01,대구,9,8,1,10614
2021-07-01,부산,29,25,4,6268
2021-07-01,서울,347,337,10,50667
2021-07-01,합계,826,765,61,158548
2021-06-30,검역,31,0,31,4247
2021-06-30,제주,1,1,0,1265
2021-06-30,경남,10,10,0,5257
2021-06-30,경북,5,4,1,4954
2021-06-30,전남,5,5,0,1653
2021-06-30,전북,7,7,0,2371
2021-06-30,충남,15,13,2,3819
2021-06-30,충북,4,4,0,3310
2021-06-30,강원,10,8,2,3569
2021-06-30,경기,249,245,4,44308
2021-06-30,세종,5,5,0,565
2021-06-30,울산,2,1,1,2826
2021-06-30,대전,16,16,0,2667
2021-06-30,광주,7,7,0,2944
2021-06-30,인천,36,30,6,6803
2021-06-30,대구,7,7,0,10605
2021-06-30,부산,18,17,1,6239
2021-06-30,서울,333,331,2,50321
2021-06-30,합계,761,711,50,157723
2021-06-29,검역,17,0,17,4216
2021-06-29,제주,2,2,0,1264
2021-06-29,경남,17,16,1,5247
2021-06-29,경북,4,3,1,4949
2021-06-29,전남,7,7,0,1648
2021-06-29,전북,10,10,0,2364
2021-06-29,충남,8,8,0,3804
2021-06-29,충북,5,5,0,3306
2021-06-29,강원,15,14,1,3559
2021-06-29,경기,240,234,6,44059
2021-06-29,세종,3,3,0,560
2021-06-29,울산,4,4,0,2824
2021-06-29,대전,26,26,0,2651
2021-06-29,광주,6,6,0,2937
2021-06-29,인천,30,29,1,6767
2021-06-29,대구,11,11,0,10598
2021-06-29,부산,14,13,1,6221
2021-06-29,서울,375,368,7,49987
2021-06-29,합계,794,759,35,156961
2021-06-28,검역,16,0,16,4199
2021-06-28,제주,6,6,0,1262
2021-06-28,경남,15,13,2,5230
2021-06-28,경북,6,5,1,4945
2021-06-28,전남,4,2,2,1641
2021-06-28,전북,7,7,0,2354
2021-06-28,충남,11,11,0,3796
2021-06-28,충북,10,7,3,3301
2021-06-28,강원,8,8,0,3544
2021-06-28,경기,230,228,2,43819
2021-06-28,세종,3,3,0,557
2021-06-28,울산,13,13,0,2820
2021-06-28,대전,25,25,0,2625
2021-06-28,광주,2,2,0,2931
2021-06-28,인천,17,17,0,6737
2021-06-28,대구,8,6,2,10587
2021-06-28,부산,9,6,3,6207
2021-06-28,서울,205,201,4,49612
2021-06-28,합계,595,560,35,156167
2021-06-27,검역,11,0,11,4183
2021-06-27,제주,2,2,0,1256
2021-06-27,경남,10,10,0,5215
2021-06-27,경북,1,1,0,4939
2021-06-27,전남,2,2,0,1637
2021-06-27,전북,2,2,0,2347
2021-06-27,충남,8,6,2,3785
2021-06-27,충북,5,5,0,3291
2021-06-27,강원,17,16,1,3536
2021-06-27,경기,162,157,5,43589
2021-06-27,세종,0,0,0,554
2021-06-27,울산,8,7,1,2807
2021-06-27,대전,7,7,0,2600
2021-06-27,광주,7,6,1,2929
2021-06-27,인천,31,30,1,6720
2021-06-27,대구,5,5,0,10579
2021-06-27,부산,38,37,1,6198
2021-06-27,서울,185,179,6,49407
2021-06-27,합계,501,472,29,155572
2021-06-26,검역,34,0,34,4172
2021-06-26,제주,2,2,0,1254
2021-06-26,경남,14,13,1,5205
2021-06-26,경북,4,4,0,4938
2021-06-26,전남,6,5,1,1635
2021-06-26,전북,6,6,0,2345
2021-06-26,충남,24,23,1,3777
2021-06-26,충북,4,3,1,3286
2021-06-26,강원,19,19,0,3519
2021-06-26,경기,173,171,2,43427
2021-06-26,세종,8,8,0,554
2021-06-26,울산,6,3,3,2799
2021-06-26,대전,15,15,0,2593
2021-06-26,광주,12,12,0,2922
2021-06-26,인천,25,24,1,6689
2021-06-26,대구,8,8,0,10574
2021-06-26,부산,12,12,0,6160
2021-06-26,서울,242,242,0,49222
2021-06-26,합계,614,570,44,155071
2021-06-25,검역,31,0,31,4138
2021-06-25,제주,9,9,0,1252
2021-06-25,경남,12,12,0,5191
2021-06-25,경북,9,9,0,4934
2021-06-25,전남,3,3,0,1629
2021-06-25,전북,5,3,2,2339
2021-06-25,충남,7,6,1,3753
2021-06-25,충북,5,5,0,3282
2021-06-25,강원,35,23,12,3500
2021-06-25,경기,188,185,3,43254
2021-06-25,세종,2,2,0,546
2021-06-25,울산,22,22,0,2793
2021-06-25,대전,13,12,1,2578
2021-06-25,광주,8,7,1,2910
2021-06-25,인천,12,12,0,6664
2021-06-25,대구,13,13,0,10566
2021-06-25,부산,31,28,3,6148
2021-06-25,서울,263,260,3,48980
2021-06-25,합계,668,611,57,154457
2021-06-24,검역,13,0,13,4107
2021-06-24,제주,5,4,1,1243
2021-06-24,경남,17,17,0,5179
2021-06-24,경북,7,6,1,4925
2021-06-24,전남,18,17,1,1626
2021-06-24,전북,2,1,1,2334
2021-06-24,충남,4,4,0,3746
2021-06-24,충북,10,10,0,3277
2021-06-24,강원,13,13,0,3465
2021-06-24,경기,183,179,4,43066
2021-06-24,세종,2,2,0,544
2021-06-24,울산,16,16,0,2771
2021-06-24,대전,9,8,1,2565
2021-06-24,광주,5,5,0,2902
2021-06-24,인천,29,24,5,6652
2021-06-24,대구,5,5,0,10553
2021-06-24,부산,27,27,0,6117
2021-06-24,서울,269,264,5,48717
2021-06-24,합계,634,602,32,153789
2021-06-23,검역,19,0,19,4094
2021-06-23,제주,4,3,1,1238
2021-06-23,경남,23,22,1,5162
2021-06-23,경북,29,28,1,4918
2021-06-23,전남,6,3,3,1608
2021-06-23,전북,6,6,0,2332
2021-06-23,충남,7,7,0,3742
2021-06-23,충북,6,5,1,3267
2021-06-23,강원,5,5,0,3452
2021-06-23,경기,185,184,1,42883
2021-06-23,세종,1,1,0,542
2021-06-23,울산,13,11,2,2755
2021-06-23,대전,15,15,0,2556
2021-06-23,광주,1,1,0,2897
2021-06-23,인천,15,15,0,6623
2021-06-23,대구,3,3,0,10548
2021-06-23,부산,20,16,4,6090
2021-06-23,서울,252,251,1,48448
2021-06-23,합계,610,576,34,153155
2021-06-22,검역,13,0,13,4075
2021-06-22,제주,0,0,0,1234
2021-06-22,경남,18,18,0,5139
2021-06-22,경북,21,21,0,4889
2021-06-22,전남,2,2,0,1602
2021-06-22,전북,2,2,0,2326
2021-06-22,충남,9,9,0,3735
2021-06-22,충북,10,10,0,3261
2021-06-22,강원,17,17,0,3447
2021-06-22,경기,191,180,11,42698
2021-06-22,세종,8,7,1,541
2021-06-22,울산,5,5,0,2742
2021-06-22,대전,58,57,1,2541
2021-06-22,광주,4,4,0,2896
2021-06-22,인천,28,26,2,6608
2021-06-22,대구,7,6,1,10545
2021-06-22,부산,16,13,3,6070
2021-06-22,서울,236,228,8,48196
2021-06-22,합계,645,605,40,152545
2021-06-21,검역,29,0,29,4062
2021-06-21,제주,1,1,0,1234
2021-06-21,경남,11,11,0,5121
2021-06-21,경북,11,10,1,4868
2021-06-21,전남,8,6,2,1600
2021-06-21,전북,2,2,0,2324
2021-06-21,충남,12,11,1,3726
2021-06-21,충북,16,16,0,3251
2021-06-21,강원,10,10,0,3430
2021-06-21,경기,92,92,0,42507
2021-06-21,세종,6,6,0,533
2021-06-21,울산,5,4,1,2737
2021-06-21,대전,31,30,1,2483
2021-06-21,광주,2,2,0,2892
2021-06-21,인천,18,15,3,6580
2021-06-21,대구,3,3,0,10538
2021-06-21,부산,6,6,0,6054
2021-06-21,서울,132,126,6,47960
2021-06-21,합계,394,350,44,151900
2021-06-20,검역,12,0,12,4033
2021-06-20,제주,3,2,1,1233
2021-06-20,경남,13,10,3,5110
2021-06-20,경북,8,6,2,4857
2021-06-20,전남,10,10,0,1592
2021-06-20,전북,3,3,0,2322
2021-06-20,충남,11,11,0,3714
2021-06-20,충북,3,2,1,3235
2021-06-20,강원,9,7,2,3420
2021-06-20,경기,91,88,3,42415
2021-06-20,세종,2,2,0,527
2021-06-20,울산,0,0,0,2732
2021-06-20,대전,15,14,1,2452
2021-06-20,광주,2,1,1,2890
2021-06-20,인천,9,7,2,6562
2021-06-20,대구,18,16,2,10535
2021-06-20,부산,14,11,3,6048
2021-06-20,서울,134,127,7,47829
2021-06-20,합계,357,317,40,151506
2021-06-19,검역,19,0,19,4021
2021-06-19,제주,2,2,0,1230
2021-06-19,경남,11,10,1,5097
2021-06-19,경북,6,5,1,4849
2021-06-19,전남,3,3,0,1582
2021-06-19,전북,3,3,0,2319
2021-06-19,충남,10,10,0,3703
2021-06-19,충북,6,6,0,3232
2021-06-19,강원,13,13,0,3411
2021-06-19,경기,113,111,2,42324
2021-06-19,세종,3,2,1,525
2021-06-19,울산,5,5,0,2732
2021-06-19,대전,8,8,0,2437
2021-06-19,광주,3,2,1,2888
2021-06-19,인천,22,19,3,6553
2021-06-19,대구,16,15,1,10517
2021-06-19,부산,21,14,7,6034
2021-06-19,서울,165,152,13,47695
2021-06-19,합계,429,380,49,151149
2021-06-18,검역,12,0,12,4002
2021-06-18,제주,7,7,0,1228
2021-06-18,경남,11,10,1,5086
2021-06-18,경북,4,4,0,4843
2021-06-18,전남,5,5,0,1579
2021-06-18,전북,5,5,0,2316
2021-06-18,충남,12,12,0,3693
2021-06-18,충북,10,10,0,3226
2021-06-18,강원,5,5,0,3398
2021-06-18,경기,145,141,4,42211
2021-06-18,세종,2,2,0,522
2021-06-18,울산,5,5,0,2727
2021-06-18,대전,5,5,0,2429
2021-06-18,광주,4,4,0,2885
2021-06-18,인천,22,20,2,6531
2021-06-18,대구,13,13,0,10501
2021-06-18,부산,18,15,3,6013
2021-06-18,서울,197,193,4,47530
2021-06-18,합계,482,456,26,150720
2021-06-17,검역,10,0,10,3990
2021-06-17,제주,6,6,0,1221
2021-06-17,경남,14,12,2,5075
2021-06-17,경북,11,10,1,4839
2021-06-17,전남,4,4,0,1574
2021-06-17,전북,4,3,1,2311
2021-06-17,충남,7,7,0,3681
2021-06-17,충북,19,19,0,3216
2021-06-17,강원,9,9,0,3393
2021-06-17,경기,153,151,2,42066
2021-06-17,세종,1,1,0,520
2021-06-17,울산,11,11,0,2722
2021-06-17,대전,13,12,1,2424
2021-06-17,광주,2,1,1,2881
2021-06-17,인천,22,21,1,6509
2021-06-17,대구,11,11,0,10488
2021-06-17,부산,10,9,1,5995
2021-06-17,서울,200,197,3,47333
2021-06-17,합계,507,484,23,150238
2021-06-16,검역,8,0,8,3980
2021-06-16,제주,8,8,0,1215
2021-06-16,경남,5,5,0,5061
2021-06-16,경북,3,3,0,4828
2021-06-16,전남,6,6,0,1570
2021-06-16,전북,7,6,1,2307
2021-06-16,충남,5,5,0,3674
2021-06-16,충북,18,18,0,3197
2021-06-16,강원,7,6,1,3384
2021-06-16,경기,183,181,2,41913
2021-06-16,세종,2,1,1,519
2021-06-16,울산,22,22,0,2711
2021-06-16,대전,18,18,0,2411
2021-06-16,광주,6,6,0,2879
2021-06-16,인천,17,17,0,6487
2021-06-16,대구,7,7,0,10477
2021-06-16,부산,17,15,2,5985
2021-06-16,서울,201,199,2,47133
2021-06-16,합계,540,523,17,149731
2021-06-15,검역,8,0,8,3972
2021-06-15,제주,9,9,0,1207
2021-06-15,경남,7,7,0,5056
2021-06-15,경북,3,3,0,4825
2021-06-15,전남,8,8,0,1564
2021-06-15,전북,2,2,0,2300
2021-06-15,충남,8,7,1,3669
2021-06-15,충북,17,17,0,3179
2021-06-15,강원,7,7,0,3377
2021-06-15,경기,190,184,6,41730
2021-06-15,세종,4,4,0,517
2021-06-15,울산,7,6,1,2689
2021-06-15,대전,29,28,1,2393
2021-06-15,광주,1,1,0,2873
2021-06-15,인천,12,11,1,6470
2021-06-15,대구,16,16,0,10470
2021-06-15,부산,16,13,3,5968
2021-06-15,서울,201,199,2,46932
2021-06-15,합계,545,522,23,149191
2021-06-14,검역,9,0,9,3964
2021-06-14,제주,6,6,0,1198
2021-06-14,경남,3,3,0,5049
2021-06-14,경북,5,2,3,4822
2021-06-14,전남,3,3,0,1556
2021-06-14,전북,4,4,0,2298
2021-06-14,충남,7,6,1,3661
2021-06-14,충북,14,14,0,3162
2021-06-14,강원,3,2,1,3370
2021-06-14,경기,120,118,2,41540
2021-06-14,세종,8,7,1,513
2021-06-14,울산,4,4,0,2682
2021-06-14,대전,15,14,1,2364
2021-06-14,광주,4,3,1,2872
2021-06-14,인천,12,11,1,6458
2021-06-14,대구,16,16,0,10454
2021-06-14,부산,9,6,3,5952
2021-06-14,서울,131,127,4,46731
2021-06-14,합계,373,346,27,148646
2021-06-13,검역,16,0,16,3955
2021-06-13,제주,9,9,0,1192
2021-06-13,경남,13,13,0,5046
2021-06-13,경북,4,4,0,4817
2021-06-13,전남,4,4,0,1553
2021-06-13,전북,2,2,0,2294
2021-06-13,충남,7,7,0,3654
2021-06-13,충북,23,23,0,3148
2021-06-13,강원,11,10,1,3367
2021-06-13,경기,122,113,9,41420
2021-06-13,세종,1,0,1,505
2021-06-13,울산,0,0,0,2678
2021-06-13,대전,10,10,0,2349
2021-06-13,광주,4,3,1,2868
2021-06-13,인천,14,13,1,6446
2021-06-13,대구,20,19,1,10438
2021-06-13,부산,17,10,7,5943
2021-06-13,서울,120,118,2,46598
2021-06-13,합계,397,358,39,148271
2021-06-12,검역,17,0,17,3939
2021-06-12,제주,5,5,0,1183
2021-06-12,경남,8,7,1,5033
2021-06-12,경북,7,7,0,4813
2021-06-12,전남,3,3,0,1549
2021-06-12,전북,1,1,0,2292
2021-06-12,충남,10,8,2,3647
2021-06-12,충북,6,6,0,3125
2021-06-12,강원,10,10,0,3356
2021-06-12,경기,149,142,7,41298
2021-06-12,세종,1,1,0,504
2021-06-12,울산,2,2,0,2678
2021-06-12,대전,11,11,0,2339
2021-06-12,광주,3,2,1,2864
2021-06-12,인천,15,13,2,6432
2021-06-12,대구,15,14,1,10418
2021-06-12,부산,13,13,0,5926
2021-06-12,서울,174,172,2,46476
2021-06-12,합계,450,417,33,147872
2021-06-11,검역,9,0,9,3922
2021-06-11,제주,5,5,0,1178
2021-06-11,경남,25,23,2,5025
2021-06-11,경북,5,5,0,4806
2021-06-11,전남,4,4,0,1546
2021-06-11,전북,2,2,0,2291
2021-06-11,충남,5,4,1,3637
2021-06-11,충북,12,12,0,3119
2021-06-11,강원,11,10,1,3346
2021-06-11,경기,174,170,4,41149
2021-06-11,세종,1,0,1,503
2021-06-11,울산,6,6,0,2676
2021-06-11,대전,22,22,0,2328
2021-06-11,광주,7,4,3,2861
2021-06-11,인천,20,19,1,6417
2021-06-11,대구,23,21,2,10403
2021-06-11,부산,26,13,13,5913
2021-06-11,서울,206,203,3,46300
2021-06-11,합계,563,523,40,147420
2021-06-10,검역,4,0,4,3913
2021-06-10,제주,5,5,0,1173
2021-06-10,경남,20,20,0,5000
2021-06-10,경북,6,6,0,4801
2021-06-10,전남,5,5,0,1542
2021-06-10,전북,4,4,0,2289
2021-06-10,충남,5,5,0,3632
2021-06-10,충북,16,16,0,3107
2021-06-10,강원,11,10,1,3335
2021-06-10,경기,173,172,1,40975
2021-06-10,세종,2,1,1,502
2021-06-10,울산,15,15,0,2670
2021-06-10,대전,15,15,0,2306
2021-06-10,광주,1,1,0,2854
2021-06-10,인천,18,17,1,6397
2021-06-10,대구,24,23,1,10380
2021-06-10,부산,28,25,3,5887
2021-06-10,서울,202,199,3,46092
2021-06-10,합계,554,539,15,146855
2021-06-09,검역,8,0,8,3909
2021-06-09,제주,10,10,0,1168
2021-06-09,경남,33,33,0,4980
2021-06-09,경북,11,9,2,4795
2021-06-09,전남,4,4,0,1537
2021-06-09,전북,2,2,0,2285
2021-06-09,충남,7,7,0,3627
2021-06-09,충북,24,24,0,3091
2021-06-09,강원,16,16,0,3324
2021-06-09,경기,180,176,4,40802
2021-06-09,세종,3,3,0,500
2021-06-09,울산,7,7,0,2655
2021-06-09,대전,22,21,1,2291
2021-06-09,광주,4,3,1,2853
2021-06-09,인천,22,22,0,6379
2021-06-09,대구,30,29,1,10356
2021-06-09,부산,15,15,0,5859
2021-06-09,서울,211,211,0,45890
2021-06-09,합계,609,592,17,146301
2021-06-08,검역,5,0,5,3901
2021-06-08,제주,7,6,1,1158
2021-06-08,경남,39,39,0,4947
2021-06-08,경북,13,12,1,4784
2021-06-08,전남,6,6,0,1533
2021-06-08,전북,6,6,0,2283
2021-06-08,충남,5,4,1,3620
2021-06-08,충북,23,23,0,3067
2021-06-08,강원,30,29,1,3308
2021-06-08,경기,161,155,6,40622
2021-06-08,세종,3,3,0,497
2021-06-08,울산,6,6,0,2648
2021-06-08,대전,25,25,0,2269
2021-06-08,광주,7,7,0,2849
2021-06-08,인천,23,21,2,6357
2021-06-08,대구,44,44,0,10326
2021-06-08,부산,16,14,2,5844
2021-06-08,서울,181,179,2,45677
2021-06-08,합계,600,579,21,145690
2021-06-07,검역,8,0,8,3896
2021-06-07,제주,8,7,1,1151
2021-06-07,경남,48,48,0,4908
2021-06-07,경북,7,6,1,4771
2021-06-07,전남,8,8,0,1527
2021-06-07,전북,4,3,1,2277
2021-06-07,충남,4,3,1,3615
2021-06-07,충북,6,6,0,3044
2021-06-07,강원,5,5,0,3278
2021-06-07,경기,130,125,5,40461
2021-06-07,세종,0,0,0,494
2021-06-07,울산,3,3,0,2642
2021-06-07,대전,22,22,0,2244
2021-06-07,광주,1,1,0,2842
2021-06-07,인천,13,11,2,6334
2021-06-07,대구,33,33,0,10282
2021-06-07,부산,15,15,0,5828
2021-06-07,서울,138,138,0,45495
2021-06-07,합계,452,434,18,145089
2021-06-06,검역,10,0,10,3888
2021-06-06,제주,13,13,0,1143
2021-06-06,경남,28,27,1,4860
2021-06-06,경북,9,8,1,4764
2021-06-06,전남,3,3,0,1519
2021-06-06,전북,3,3,0,2273
2021-06-06,충남,9,9,0,3611
2021-06-06,충북,11,10,1,3038
2021-06-06,강원,2,2,0,3273
2021-06-06,경기,151,146,5,40331
2021-06-06,세종,0,0,0,494
2021-06-06,울산,10,10,0,2639
2021-06-06,대전,20,20,0,2222
2021-06-06,광주,4,4,0,2841
2021-06-06,인천,15,15,0,6321
2021-06-06,대구,26,26,0,10249
2021-06-06,부산,12,9,3,5813
2021-06-06,서울,158,148,10,45356
2021-06-06,합계,484,453,31,144635
2021-06-05,검역,5,0,5,3878
2021-06-05,제주,19,17,2,1130
2021-06-05,경남,17,17,0,4832
2021-06-05,경북,10,9,1,4755
2021-06-05,전남,9,9,0,1516
2021-06-05,전북,0,0,0,2270
2021-06-05,충남,13,13,0,3602
2021-06-05,충북,17,17,0,3027
2021-06-05,강원,10,10,0,3271
2021-06-05,경기,160,157,3,40180
2021-06-05,세종,0,0,0,494
2021-06-05,울산,7,7,0,2629
2021-06-05,대전,18,18,0,2202
2021-06-05,광주,2,2,0,2837
2021-06-05,인천,23,22,1,6306
2021-06-05,대구,46,45,1,10223
2021-06-05,부산,21,21,0,5801
2021-06-05,서울,178,176,2,45197
2021-06-05,합계,555,540,15,144150
2021-06-04,검역,5,0,5,3873
2021-06-04,제주,22,22,0,1111
2021-06-04,경남,20,20,0,4815
2021-06-04,경북,10,10,0,4745
2021-06-04,전남,14,14,0,1507
2021-06-04,전북,14,13,1,2270
2021-06-04,충남,10,9,1,3589
2021-06-04,충북,24,24,0,3010
2021-06-04,강원,14,14,0,3261
2021-06-04,경기,211,206,5,40020
2021-06-04,세종,4,4,0,494
2021-06-04,울산,5,5,0,2622
2021-06-04,대전,31,31,0,2184
2021-06-04,광주,9,9,0,2835
2021-06-04,인천,16,16,0,6283
2021-06-04,대구,41,41,0,10177
2021-06-04,부산,17,13,4,5780
2021-06-04,서울,276,273,3,45018
2021-06-04,합계,743,724,19,143594
2021-06-03,검역,8,0,8,3868
2021-06-03,제주,21,21,0,1089
2021-06-03,경남,44,43,1,4795
2021-06-03,경북,11,8,3,4735
2021-06-03,전남,12,12,0,1493
2021-06-03,전북,3,3,0,2256
2021-06-03,충남,9,9,0,3579
2021-06-03,충북,22,21,1,2986
2021-06-03,강원,18,18,0,3247
2021-06-03,경기,209,204,5,39809
2021-06-03,세종,3,3,0,490
2021-06-03,울산,15,14,1,2617
2021-06-03,대전,18,18,0,2153
2021-06-03,광주,7,7,0,2826
2021-06-03,인천,10,10,0,6267
2021-06-03,대구,65,65,0,10136
2021-06-03,부산,14,13,1,5763
2021-06-03,서울,205,204,1,44741
2021-06-03,합계,694,673,21,142850
2021-06-02,검역,3,0,3,3860
2021-06-02,제주,12,12,0,1068
2021-06-02,경남,23,23,0,4751
2021-06-02,경북,11,11,0,4724
2021-06-02,전남,3,3,0,1481
2021-06-02,전북,12,12,0,2253
2021-06-02,충남,13,13,0,3570
2021-06-02,충북,5,5,0,2964
2021-06-02,강원,17,16,1,3229
2021-06-02,경기,211,207,4,39600
2021-06-02,세종,1,1,0,487
2021-06-02,울산,8,8,0,2602
2021-06-02,대전,15,15,0,2135
2021-06-02,광주,4,4,0,2819
2021-06-02,인천,22,22,0,6257
2021-06-02,대구,74,73,1,10071
2021-06-02,부산,32,32,0,5749
2021-06-02,서울,214,214,0,44535
2021-06-02,합계,680,671,9,142155
2021-06-01,검역,9,0,9,3857
2021-06-01,제주,14,14,0,1056
2021-06-01,경남,21,19,2,4728
2021-06-01,경북,12,9,3,4713
2021-06-01,전남,10,10,0,1478
2021-06-01,전북,10,10,0,2241
2021-06-01,충남,7,7,0,3557
2021-06-01,충북,5,5,0,2959
2021-06-01,강원,14,14,0,3212
2021-06-01,경기,192,188,4,39389
2021-06-01,세종,3,3,0,486
2021-06-01,울산,14,14,0,2594
2021-06-01,대전,23,23,0,2120
2021-06-01,광주,5,5,0,2815
2021-06-01,인천,20,19,1,6235
2021-06-01,대구,39,39,0,9997
2021-06-01,부산,21,19,2,5717
2021-06-01,서울,257,255,2,44320
2021-06-01,합계,676,653,23,141474
2021-05-31,검역,4,0,4,3848
2021-05-31,제주,12,12,0,1042
2021-05-31,경남,8,8,0,4707
2021-05-31,경북,9,9,0,4701
2021-05-31,전남,5,5,0,1468
2021-05-31,전북,6,6,0,2231
2021-05-31,충남,12,11,1,3550
2021-05-31,충북,11,11,0,2954
2021-05-31,강원,13,13,0,3198
2021-05-31,경기,116,116,0,39197
2021-05-31,세종,3,3,0,483
2021-05-31,울산,2,2,0,2580
2021-05-31,대전,19,19,0,2097
2021-05-31,광주,5,5,0,2810
2021-05-31,인천,17,16,1,6215
2021-05-31,대구,42,39,3,9958
2021-05-31,부산,28,28,0,5696
2021-05-31,서울,146,145,1,44062
2021-05-31,합계,458,448,10,140797
2021-05-30,검역,7,0,7,3844
2021-05-30,제주,7,6,1,1030
2021-05-30,경남,16,15,1,4699
2021-05-30,경북,18,15,3,4692
2021-05-30,전남,6,6,0,1463
2021-05-30,전북,9,9,0,2225
2021-05-30,충남,4,4,0,3538
2021-05-30,충북,7,7,0,2943
2021-05-30,강원,11,11,0,3185
2021-05-30,경기,130,127,3,39081
2021-05-30,세종,3,3,0,480
2021-05-30,울산,3,3,0,2578
2021-05-30,대전,6,6,0,2078
2021-05-30,광주,13,13,0,2805
2021-05-30,인천,12,10,2,6198
2021-05-30,대구,31,31,0,9916
2021-05-30,부산,17,16,1,5668
2021-05-30,서울,129,128,1,43915
2021-05-30,합계,429,410,19,140338
2021-05-29,검역,7,0,7,3837
2021-05-29,제주,8,8,0,1023
2021-05-29,경남,10,9,1,4683
2021-05-29,경북,9,9,0,4674
2021-05-29,전남,9,9,0,1457
2021-05-29,전북,7,7,0,2216
2021-05-29,충남,7,5,2,3534
2021-05-29,충북,6,6,0,2936
2021-05-29,강원,17,17,0,3174
2021-05-29,경기,160,156,4,38951
2021-05-29,세종,6,6,0,477
2021-05-29,울산,7,6,1,2575
2021-05-29,대전,7,7,0,2072
2021-05-29,광주,9,9,0,2792
2021-05-29,인천,18,18,0,6186
2021-05-29,대구,20,20,0,9885
2021-05-29,부산,13,13,0,5651
2021-05-29,서울,159,158,1,43785
2021-05-29,합계,479,463,16,139908
2021-05-28,검역,16,0,16,3830
2021-05-28,제주,13,12,1,1015
2021-05-28,경남,20,19,1,4673
2021-05-28,경북,13,13,0,4665
2021-05-28,전남,5,5,0,1448
2021-05-28,전북,6,6,0,2209
2021-05-28,충남,12,10,2,3527
2021-05-28,충북,22,22,0,2930
2021-05-28,강원,10,10,0,3157
2021-05-28,경기,139,136,3,38791
2021-05-28,세종,1,1,0,471
2021-05-28,울산,8,8,0,2568
2021-05-28,대전,11,11,0,2065
2021-05-28,광주,9,9,0,2783
2021-05-28,인천,18,17,1,6168
2021-05-28,대구,22,22,0,9865
2021-05-28,부산,14,14,0,5638
2021-05-28,서울,193,189,4,43625
2021-05-28,합계,532,504,28,139428
2021-05-27,검역,11,0,11,3814
2021-05-27,제주,7,7,0,1002
2021-05-27,경남,21,21,0,4653
2021-05-27,경북,14,14,0,4652
2021-05-27,전남,7,7,0,1443
2021-05-27,전북,4,4,0,2203
2021-05-27,충남,21,21,0,3515
2021-05-27,충북,14,14,0,2908
2021-05-27,강원,16,16,0,3147
2021-05-27,경기,149,146,3,38652
2021-05-27,세종,8,8,0,470
2021-05-27,울산,12,12,0,2560
2021-05-27,대전,18,18,0,2054
2021-05-27,광주,8,8,0,2774
2021-05-27,인천,26,26,0,6150
2021-05-27,대구,24,24,0,9843
2021-05-27,부산,13,13,0,5624
2021-05-27,서울,213,211,2,43431
2021-05-27,합계,586,570,16,138895
2021-05-26,검역,3,0,3,3803
2021-05-26,제주,26,26,0,995
2021-05-26,경남,18,18,0,4632
2021-05-26,경북,12,10,2,4638
2021-05-26,전남,16,16,0,1436
2021-05-26,전북,6,6,0,2199
2021-05-26,충남,17,17,0,3494
2021-05-26,충북,9,9,0,2894
2021-05-26,강원,7,7,0,3131
2021-05-26,경기,170,168,2,38503
2021-05-26,세종,8,8,0,462
2021-05-26,울산,6,6,0,2548
2021-05-26,대전,23,23,0,2036
2021-05-26,광주,15,15,0,2766
2021-05-26,인천,30,30,0,6124
2021-05-26,대구,27,27,0,9819
2021-05-26,부산,18,18,0,5611
2021-05-26,서울,217,215,2,43217
2021-05-26,합계,628,619,9,138308
2021-05-25,검역,13,0,13,3800
2021-05-25,제주,6,6,0,969
2021-05-25,경남,20,20,0,4614
2021-05-25,경북,9,9,0,4626
2021-05-25,전남,11,11,0,1420
2021-05-25,전북,6,6,0,2193
2021-05-25,충남,19,19,0,3477
2021-05-25,충북,13,13,0,2885
2021-05-25,강원,25,25,0,3124
2021-05-25,경기,190,184,7,38333
2021-05-25,세종,9,9,0,454
2021-05-25,울산,15,15,0,2542
2021-05-25,대전,17,17,0,2013
2021-05-25,광주,21,20,1,2751
2021-05-25,인천,19,19,0,6094
2021-05-25,대구,30,30,0,9792
2021-05-25,부산,22,21,1,5593
2021-05-25,서울,260,258,2,42999
2021-05-25,합계,700,682,22,137679
2021-05-24,검역,22,0,22,3787
2021-05-24,제주,17,17,0,963
2021-05-24,경남,14,13,1,4594
2021-05-24,경북,12,11,1,4617
2021-05-24,전남,7,7,0,1409
2021-05-24,전북,5,5,0,2187
2021-05-24,충남,22,20,2,3458
2021-05-24,충북,9,8,1,2872
2021-05-24,강원,21,20,1,3099
2021-05-24,경기,136,132,4,38144
2021-05-24,세종,14,14,0,445
2021-05-24,울산,7,7,0,2527
2021-05-24,대전,15,15,0,1996
2021-05-24,광주,21,21,0,2730
2021-05-24,인천,11,11,0,6075
2021-05-24,대구,29,27,2,9762
2021-05-24,부산,16,16,0,5571
2021-05-24,서울,137,136,1,42738
2021-05-24,합계,515,480,35,136974
2021-05-23,검역,11,0,11,3765
2021-05-23,제주,19,19,0,946
2021-05-23,경남,17,17,0,4580
2021-05-23,경북,12,12,0,4605
2021-05-23,전남,14,12,2,1402
2021-05-23,전북,4,4,0,2182
2021-05-23,충남,31,28,3,3436
2021-05-23,충북,7,7,0,2863
2021-05-23,강원,20,18,2,3078
2021-05-23,경기,122,120,2,38008
2021-05-23,세종,14,14,0,431
2021-05-23,울산,12,12,0,2520
2021-05-23,대전,11,11,0,1981
2021-05-23,광주,16,15,1,2709
2021-05-23,인천,18,18,0,6064
2021-05-23,대구,48,48,0,9733
2021-05-23,부산,15,14,1,5555
2021-05-23,서울,138,135,3,42600
2021-05-23,합계,529,504,25,136458
2021-05-22,검역,10,0,10,3754
2021-05-22,제주,8,8,0,927
2021-05-22,경남,17,17,0,4563
2021-05-22,경북,12,12,0,4593
2021-05-22,전남,10,10,0,1388
2021-05-22,전북,14,14,0,2178
2021-05-22,충남,24,24,0,3405
2021-05-22,충북,9,9,0,2856
2021-05-22,강원,19,18,1,3058
2021-05-22,경기,151,150,1,37886
2021-05-22,세종,1,1,0,417
2021-05-22,울산,24,23,1,2508
2021-05-22,대전,12,12,0,1970
2021-05-22,광주,9,9,0,2693
2021-05-22,인천,12,12,0,6046
2021-05-22,대구,57,57,0,9685
2021-05-22,부산,15,14,1,5540
2021-05-22,서울,180,179,1,42461
2021-05-22,합계,584,569,15,135928
2021-05-21,검역,21,0,21,3744
2021-05-21,제주,7,7,0,919
2021-05-21,경남,21,21,0,4546
2021-05-21,경북,16,15,1,4581
2021-05-21,전남,16,16,0,1378
2021-05-21,전북,12,12,0,2164
2021-05-21,충남,17,17,0,3381
2021-05-21,충북,6,4,2,2847
2021-05-21,강원,29,29,0,3039
2021-05-21,경기,165,163,2,37735
2021-05-21,세종,0,0,0,416
2021-05-21,울산,29,29,0,2484
2021-05-21,대전,5,5,0,1958
2021-05-21,광주,15,15,0,2684
2021-05-21,인천,15,13,2,6034
2021-05-21,대구,56,55,1,9628
2021-05-21,부산,28,27,1,5525
2021-05-21,서울,207,204,3,42280
2021-05-21,합계,665,632,33,135343
2021-05-20,검역,10,0,10,3723
2021-05-20,제주,5,5,0,912
2021-05-20,경남,18,18,0,4525
2021-05-20,경북,11,11,0,4565
2021-05-20,전남,17,17,0,1362
2021-05-20,전북,16,15,1,2152
2021-05-20,충남,41,40,1,3364
2021-05-20,충북,12,12,0,2841
2021-05-20,강원,7,7,0,3010
2021-05-20,경기,164,161,3,37570
2021-05-20,세종,1,1,0,416
2021-05-20,울산,13,13,0,2455
2021-05-20,대전,15,15,0,1953
2021-05-20,광주,13,13,0,2669
2021-05-20,인천,12,12,0,6019
2021-05-20,대구,19,18,1,9572
2021-05-20,부산,15,13,2,5497
2021-05-20,서울,171,170,1,42072
2021-05-20,합계,560,541,19,134677
2021-05-19,검역,16,0,16,3713
2021-05-19,제주,6,6,0,907
2021-05-19,경남,12,12,0,4507
2021-05-19,경북,33,33,0,4554
2021-05-19,전남,7,6,1,1345
2021-05-19,전북,7,7,0,2136
2021-05-19,충남,19,19,0,3323
2021-05-19,충북,13,13,0,2829
2021-05-19,강원,8,8,0,3003
2021-05-19,경기,187,183,4,37406
2021-05-19,세종,9,8,1,415
2021-05-19,울산,25,25,0,2442
2021-05-19,대전,8,7,1,1938
2021-05-19,광주,15,15,0,2656
2021-05-19,인천,13,13,0,6007
2021-05-19,대구,9,9,0,9553
2021-05-19,부산,17,17,0,5482
2021-05-19,서울,241,237,4,41900
2021-05-19,합계,645,618,27,134116
2021-05-18,검역,7,0,7,3697
2021-05-18,제주,4,4,0,901
2021-05-18,경남,16,16,0,4495
2021-05-18,경북,24,24,0,4521
2021-05-18,전남,10,10,0,1338
2021-05-18,전북,9,9,0,2129
2021-05-18,충남,17,16,1,3304
2021-05-18,충북,21,21,0,2816
2021-05-18,강원,16,16,0,2995
2021-05-18,경기,164,159,5,37219
2021-05-18,세종,3,3,0,406
2021-05-18,울산,27,27,0,2417
2021-05-18,대전,10,10,0,1930
2021-05-18,광주,4,4,0,2641
2021-05-18,인천,23,23,0,5994
2021-05-18,대구,23,23,0,9544
2021-05-18,부산,27,27,0,5465
2021-05-18,서울,248,244,4,41658
2021-05-18,합계,653,636,17,133470
2021-05-17,검역,12,0,12,3690
2021-05-17,제주,11,10,1,897
2021-05-17,경남,16,15,1,4479
2021-05-17,경북,23,21,2,4497
2021-05-17,전남,12,12,0,1328
2021-05-17,전북,7,7,0,2120
2021-05-17,충남,15,15,0,3287
2021-05-17,충북,13,13,0,2795
2021-05-17,강원,25,25,0,2979
2021-05-17,경기,137,134,3,37056
2021-05-17,세종,4,4,0,403
2021-05-17,울산,6,6,0,2390
2021-05-17,대전,12,12,0,1920
2021-05-17,광주,11,11,0,2637
2021-05-17,인천,16,16,0,5971
2021-05-17,대구,23,23,0,9521
2021-05-17,부산,13,13,0,5438
2021-05-17,서울,171,168,3,41409
2021-05-17,합계,527,505,22,132817
2021-05-16,검역,9,0,9,3678
2021-05-16,제주,15,15,0,886
2021-05-16,경남,30,30,0,4463
2021-05-16,경북,27,27,0,4474
2021-05-16,전남,20,17,3,1316
2021-05-16,전북,9,9,0,2113
2021-05-16,충남,16,14,2,3272
2021-05-16,충북,23,22,1,2782
2021-05-16,강원,35,35,0,2954
2021-05-16,경기,150,148,2,36919
2021-05-16,세종,0,0,0,399
2021-05-16,울산,16,16,0,2384
2021-05-16,대전,2,2,0,1908
2021-05-16,광주,27,27,0,2626
2021-05-16,인천,14,12,2,5955
2021-05-16,대구,19,19,0,9498
2021-05-16,부산,12,12,0,5425
2021-05-16,서울,194,191,3,41237
2021-05-16,합계,618,596,22,132289
2021-05-15,검역,20,0,20,3669
2021-05-15,제주,9,9,0,871
2021-05-15,경남,45,44,1,4433
2021-05-15,경북,11,11,0,4447
2021-05-15,전남,13,13,0,1296
2021-05-15,전북,14,13,1,2104
2021-05-15,충남,18,14,4,3256
2021-05-15,충북,20,19,1,2759
2021-05-15,강원,5,5,0,2919
2021-05-15,경기,161,156,5,36769
2021-05-15,세종,0,0,0,399
2021-05-15,울산,11,11,0,2368
2021-05-15,대전,4,4,0,1906
2021-05-15,광주,14,14,0,2599
2021-05-15,인천,15,15,0,5941
2021-05-15,대구,6,6,0,9479
2021-05-15,부산,31,30,1,5413
2021-05-15,서울,212,207,5,41042
2021-05-15,합계,609,571,38,131670
2021-05-14,검역,9,0,9,3649
2021-05-14,제주,14,14,0,862
2021-05-14,경남,40,38,2,4388
2021-05-14,경북,19,19,0,4436
2021-05-14,전남,26,26,0,1283
2021-05-14,전북,11,10,1,2090
2021-05-14,충남,12,10,2,3238
2021-05-14,충북,5,5,0,2739
2021-05-14,강원,12,12,0,2914
2021-05-14,경기,170,168,2,36608
2021-05-14,세종,3,3,0,399
2021-05-14,울산,22,22,0,2357
2021-05-14,대전,10,10,0,1902
2021-05-14,광주,11,10,1,2585
2021-05-14,인천,16,16,0,5926
2021-05-14,대구,5,4,1,9473
2021-05-14,부산,42,41,1,5382
2021-05-14,서울,253,252,1,40829
2021-05-14,합계,680,660,20,131060
2021-05-13,검역,9,0,9,3640
2021-05-13,제주,10,10,0,848
2021-05-13,경남,32,28,4,4348
2021-05-13,경북,35,34,1,4417
2021-05-13,전남,50,50,0,1257
2021-05-13,전북,14,14,0,2079
2021-05-13,충남,22,22,0,3226
2021-05-13,충북,4,4,0,2734
2021-05-13,강원,25,25,0,2902
2021-05-13,경기,173,172,1,36438
2021-05-13,세종,7,7,0,396
2021-05-13,울산,26,26,0,2335
2021-05-13,대전,31,31,0,1892
2021-05-13,광주,11,10,1,2574
2021-05-13,인천,34,34,0,5910
2021-05-13,대구,9,9,0,9468
2021-05-13,부산,24,24,0,5340
2021-05-13,서울,230,228,2,40575
2021-05-13,합계,746,728,18,130379
2021-05-12,검역,14,0,14,3631
2021-05-12,제주,9,9,0,838
2021-05-12,경남,32,30,2,4316
2021-05-12,경북,23,22,1,4382
2021-05-12,전남,12,12,0,1207
2021-05-12,전북,10,10,0,2065
2021-05-12,충남,19,19,0,3204
2021-05-12,충북,10,10,0,2730
2021-05-12,강원,17,15,2,2877
2021-05-12,경기,226,222,4,36265
2021-05-12,세종,2,2,0,389
2021-05-12,울산,31,31,0,2309
2021-05-12,대전,18,18,0,1861
2021-05-12,광주,23,23,0,2563
2021-05-12,인천,17,17,0,5876
2021-05-12,대구,5,5,0,9459
2021-05-12,부산,20,20,0,5316
2021-05-12,서울,226,226,0,40344
2021-05-12,합계,714,691,23,129632
2021-05-11,검역,13,0,13,3617
2021-05-11,제주,13,13,0,829
2021-05-11,경남,16,15,1,4284
2021-05-11,경북,7,7,0,4359
2021-05-11,전남,17,17,0,1195
2021-05-11,전북,22,22,0,2055
2021-05-11,충남,10,10,0,3185
2021-05-11,충북,12,12,0,2720
2021-05-11,강원,17,16,1,2860
2021-05-11,경기,187,184,3,36039
2021-05-11,세종,1,1,0,387
2021-05-11,울산,31,31,0,2278
2021-05-11,대전,8,8,0,1843
2021-05-11,광주,22,22,0,2540
2021-05-11,인천,20,20,0,5859
2021-05-11,대구,6,5,1,9454
2021-05-11,부산,10,10,0,5296
2021-05-11,서울,222,219,3,40117
2021-05-11,합계,634,612,22,128917
2021-05-10,검역,12,0,12,3604
2021-05-10,제주,24,23,1,816
2021-05-10,경남,10,9,1,4268
2021-05-10,경북,15,15,0,4352
2021-05-10,전남,10,10,0,1178
2021-05-10,전북,12,12,0,2033
2021-05-10,충남,18,18,0,3175
2021-05-10,충북,4,4,0,2708
2021-05-10,강원,12,12,0,2843
2021-05-10,경기,137,127,10,35851
2021-05-10,세종,0,0,0,386
2021-05-10,울산,19,19,0,2247
2021-05-10,대전,7,7,0,1835
2021-05-10,광주,24,23,1,2518
2021-05-10,인천,21,20,1,5839
2021-05-10,대구,8,8,0,9448
2021-05-10,부산,14,13,1,5286
2021-05-10,서울,162,162,0,39894
2021-05-10,합계,509,482,27,128281
2021-05-09,검역,13,0,13,3592
2021-05-09,제주,14,14,0,792
2021-05-09,경남,16,14,2,4258
2021-05-09,경북,19,19,0,4337
2021-05-09,전남,9,9,0,1168
2021-05-09,전북,9,9,0,2021
2021-05-09,충남,15,14,1,3157
2021-05-09,충북,4,4,0,2704
2021-05-09,강원,5,4,1,2831
2021-05-09,경기,137,135,2,35714
2021-05-09,세종,7,7,0,386
2021-05-09,울산,24,24,0,2228
2021-05-09,대전,4,4,0,1828
2021-05-09,광주,9,9,0,2494
2021-05-09,인천,13,12,1,5818
2021-05-09,대구,4,3,1,9440
2021-05-09,부산,20,19,1,5272
2021-05-09,서울,141,136,5,39732
2021-05-09,합계,463,436,27,127772
2021-05-08,검역,31,0,31,3579
2021-05-08,제주,18,17,1,778
2021-05-08,경남,30,30,0,4242
2021-05-08,경북,19,19,0,4318
2021-05-08,전남,24,24,0,1159
2021-05-08,전북,8,8,0,2012
2021-05-08,충남,10,10,0,3142
2021-05-08,충북,9,8,1,2700
2021-05-08,강원,7,7,0,2826
2021-05-08,경기,149,144,5,35577
2021-05-08,세종,1,1,0,379
2021-05-08,울산,28,28,0,2204
2021-05-08,대전,2,2,0,1824
2021-05-08,광주,6,6,0,2485
2021-05-08,인천,11,11,0,5805
2021-05-08,대구,6,6,0,9436
2021-05-08,부산,10,10,0,5252
2021-05-08,서울,195,191,4,39591
2021-05-08,합계,564,522,42,127309
2021-05-07,검역,17,0,17,3548
2021-05-07,제주,5,5,0,760
2021-05-07,경남,37,37,0,4212
2021-05-07,경북,21,20,1,4299
2021-05-07,전남,12,11,1,1135
2021-05-07,전북,5,4,1,2004
2021-05-07,충남,3,3,0,3132
2021-05-07,충북,9,9,0,2691
2021-05-07,강원,27,27,0,2819
2021-05-07,경기,194,192,2,35428
2021-05-07,세종,5,5,0,378
2021-05-07,울산,48,47,1,2176
2021-05-07,대전,9,8,1,1822
2021-05-07,광주,5,5,0,2479
2021-05-07,인천,22,20,2,5794
2021-05-07,대구,13,13,0,9430
2021-05-07,부산,27,26,1,5242
2021-05-07,서울,242,240,2,39396
2021-05-07,합계,701,672,29,126745
2021-05-06,검역,4,0,4,3531
2021-05-06,제주,12,12,0,755
2021-05-06,경남,32,30,2,4175
2021-05-06,경북,12,12,0,4278
2021-05-06,전남,12,12,0,1123
2021-05-06,전북,6,6,0,1999
2021-05-06,충남,9,8,1,3129
2021-05-06,충북,5,4,1,2682
2021-05-06,강원,8,8,0,2792
2021-05-06,경기,139,136,3,35234
2021-05-06,세종,0,0,0,373
2021-05-06,울산,35,35,0,2128
2021-05-06,대전,7,7,0,1813
2021-05-06,광주,21,21,0,2474
2021-05-06,인천,14,12,2,5772
2021-05-06,대구,9,9,0,9417
2021-05-06,부산,21,20,1,5215
2021-05-06,서울,179,177,2,39154
2021-05-06,합계,525,509,16,126044
2021-05-05,검역,8,0,8,3527
2021-05-05,제주,6,6,0,743
2021-05-05,경남,17,17,0,4143
2021-05-05,경북,22,21,1,4266
2021-05-05,전남,10,10,0,1111
2021-05-05,전북,5,5,0,1993
2021-05-05,충남,15,13,2,3120
2021-05-05,충북,6,6,0,2677
2021-05-05,강원,12,12,0,2784
2021-05-05,경기,142,142,0,35095
2021-05-05,세종,1,1,0,373
2021-05-05,울산,38,38,0,2093
2021-05-05,대전,18,18,0,1806
2021-05-05,광주,8,8,0,2453
2021-05-05,인천,19,19,0,5758
2021-05-05,대구,7,7,0,9408
2021-05-05,부산,28,28,0,5194
2021-05-05,서울,212,211,1,38975
2021-05-05,합계,574,562,12,125519
2021-05-04,검역,12,0,12,3519
2021-05-04,제주,13,13,0,737
2021-05-04,경남,27,26,1,4126
2021-05-04,경북,38,38,0,4244
2021-05-04,전남,12,12,0,1101
2021-05-04,전북,6,6,0,1988
2021-05-04,충남,10,10,0,3105
2021-05-04,충북,11,11,0,2671
2021-05-04,강원,48,48,0,2772
2021-05-04,경기,168,161,7,34953
2021-05-04,세종,0,0,0,372
2021-05-04,울산,22,21,1,2055
2021-05-04,대전,18,18,0,1788
2021-05-04,광주,8,8,0,2445
2021-05-04,인천,16,16,0,5739
2021-05-04,대구,6,6,0,9401
2021-05-04,부산,23,22,1,5166
2021-05-04,서울,238,234,4,38763
2021-05-04,합계,676,651,25,124945
2021-05-03,검역,7,0,7,3507
2021-05-03,제주,8,8,0,724
2021-05-03,경남,36,35,1,4099
2021-05-03,경북,22,18,4,4206
2021-05-03,전남,9,9,0,1089
2021-05-03,전북,12,12,0,1982
2021-05-03,충남,19,18,1,3095
2021-05-03,충북,7,5,2,2660
2021-05-03,강원,22,22,0,2724
2021-05-03,경기,124,117,7,34785
2021-05-03,세종,6,5,1,372
2021-05-03,울산,29,29,0,2033
2021-05-03,대전,13,13,0,1770
2021-05-03,광주,4,4,0,2437
2021-05-03,인천,13,12,1,5723
2021-05-03,대구,10,9,1,9395
2021-05-03,부산,16,16,0,5143
2021-05-03,서울,184,182,2,38525
2021-05-03,합계,541,514,27,124269
2021-05-02,검역,11,0,11,3500
2021-05-02,제주,1,0,1,716
2021-05-02,경남,44,44,0,4063
2021-05-02,경북,32,31,1,4184
2021-05-02,전남,24,24,0,1080
2021-05-02,전북,12,12,0,1970
2021-05-02,충남,10,10,0,3076
2021-05-02,충북,9,9,0,2653
2021-05-02,강원,10,9,1,2702
2021-05-02,경기,130,129,1,34661
2021-05-02,세종,4,3,1,366
2021-05-02,울산,21,21,0,2004
2021-05-02,대전,5,5,0,1757
2021-05-02,광주,5,5,0,2433
2021-05-02,인천,15,14,1,5710
2021-05-02,대구,12,10,2,9385
2021-05-02,부산,16,16,0,5127
2021-05-02,서울,127,123,4,38341
2021-05-02,합계,488,465,23,123728
2021-05-01,검역,6,0,6,3489
2021-05-01,제주,1,0,1,715
2021-05-01,경남,61,61,0,4019
2021-05-01,경북,30,30,0,4152
2021-05-01,전남,1,1,0,1056
2021-05-01,전북,12,12,0,1958
2021-05-01,충남,16,16,0,3066
2021-05-01,충북,11,10,1,2644
2021-05-01,강원,4,4,0,2692
2021-05-01,경기,145,140,5,34531
2021-05-01,세종,1,1,0,362
2021-05-01,울산,52,52,0,1983
2021-05-01,대전,9,8,1,1752
2021-05-01,광주,15,15,0,2428
2021-05-01,인천,17,17,0,5695
2021-05-01,대구,10,10,0,9373
2021-05-01,부산,33,31,2,5111
2021-05-01,서울,182,177,5,38214
2021-05-01,합계,606,585,21,123240
2021-04-30,검역,15,0,15,3483
2021-04-30,제주,7,7,0,714
2021-04-30,경남,43,41,2,3958
2021-04-30,경북,12,11,1,4122
2021-04-30,전남,2,2,0,1055
2021-04-30,전북,10,9,1,1946
2021-04-30,충남,17,16,1,3050
2021-04-30,충북,5,4,1,2633
2021-04-30,강원,4,4,0,2688
2021-04-30,경기,190,187,3,34386
2021-04-30,세종,4,4,0,361
2021-04-30,울산,52,52,0,1931
2021-04-30,대전,13,12,1,1743
2021-04-30,광주,4,4,0,2413
2021-04-30,인천,13,13,0,5678
2021-04-30,대구,12,12,0,9363
2021-04-30,부산,29,28,1,5078
2021-04-30,서울,195,187,8,38032
2021-04-30,합계,627,593,34,122634
2021-04-29,검역,5,0,5,3468
2021-04-29,제주,1,0,1,707
2021-04-29,경남,37,37,0,3915
2021-04-29,경북,29,28,1,4110
2021-04-29,전남,5,5,0,1053
2021-04-29,전북,21,21,0,1936
2021-04-29,충남,12,12,0,3033
2021-04-29,충북,12,11,1,2628
2021-04-29,강원,4,4,0,2684
2021-04-29,경기,151,148,3,34196
2021-04-29,세종,1,1,0,357
2021-04-29,울산,61,61,0,1879
2021-04-29,대전,31,30,1,1730
2021-04-29,광주,4,4,0,2409
2021-04-29,인천,14,14,0,5665
2021-04-29,대구,14,13,1,9351
2021-04-29,부산,32,31,1,5049
2021-04-29,서울,227,222,5,37837
2021-04-29,합계,661,642,19,122007
2021-04-28,검역,11,0,11,3463
2021-04-28,제주,1,1,0,706
2021-04-28,경남,38,38,0,3878
2021-04-28,경북,25,24,2,4081
2021-04-28,전남,2,0,2,1048
2021-04-28,전북,9,9,0,1915
2021-04-28,충남,16,15,1,3021
2021-04-28,충북,10,10,0,2616
2021-04-28,강원,13,12,1,2680
2021-04-28,경기,182,176,6,34045
2021-04-28,세종,0,0,0,356
2021-04-28,울산,46,46,0,1818
2021-04-28,대전,4,4,0,1699
2021-04-28,광주,8,8,0,2405
2021-04-28,인천,25,22,3,5651
2021-04-28,대구,19,18,1,9337
2021-04-28,부산,40,39,1,5017
2021-04-28,서울,227,225,2,37610
2021-04-28,합계,679,649,30,121346
2021-04-27,검역,7,0,7,3452
2021-04-27,제주,3,3,0,705
2021-04-27,경남,55,55,0,3840
2021-04-27,경북,25,23,2,4053
2021-04-27,전남,5,5,0,1046
2021-04-27,전북,13,13,0,1906
2021-04-27,충남,38,38,0,3005
2021-04-27,충북,22,22,0,2606
2021-04-27,강원,11,11,0,2667
2021-04-27,경기,194,189,5,33863
2021-04-27,세종,2,2,0,356
2021-04-27,울산,33,33,0,1772
2021-04-27,대전,10,10,0,1695
2021-04-27,광주,12,11,1,2397
2021-04-27,인천,20,19,1,5626
2021-04-27,대구,29,27,2,9318
2021-04-27,부산,33,32,1,4977
2021-04-27,서울,257,255,2,37383
2021-04-27,합계,769,748,21,120667
2021-04-26,검역,23,0,23,3445
2021-04-26,제주,5,5,0,702
2021-04-26,경남,28,27,1,3785
2021-04-26,경북,22,20,2,4028
2021-04-26,전남,2,2,0,1041
2021-04-26,전북,5,4,1,1893
2021-04-26,충남,14,14,0,2967
2021-04-26,충북,10,9,1,2584
2021-04-26,강원,2,2,0,2656
2021-04-26,경기,195,191,4,33669
2021-04-26,세종,2,2,0,354
2021-04-26,울산,18,18,0,1739
2021-04-26,대전,8,8,0,1685
2021-04-26,광주,6,6,0,2385
2021-04-26,인천,14,14,0,5606
2021-04-26,대구,12,9,3,9289
2021-04-26,부산,30,30,0,4944
2021-04-26,서울,116,116,0,37126
2021-04-26,합계,512,477,35,119898
2021-04-25,검역,20,0,20,3420
2021-04-25,제주,1,1,0,697
2021-04-25,경남,29,29,0,3757
2021-04-25,경북,25,24,1,4006
2021-04-25,전남,0,0,0,1039
2021-04-25,전북,6,5,1,1888
2021-04-25,충남,7,7,0,2953
2021-04-25,충북,16,16,0,2574
2021-04-25,강원,12,12,0,2654
2021-04-25,경기,150,147,3,33474
2021-04-25,세종,1,1,0,352
2021-04-25,울산,13,13,0,1721
2021-04-25,대전,4,4,0,1677
2021-04-25,광주,15,15,0,2379
2021-04-25,인천,14,13,1,5592
2021-04-25,대구,7,7,0,9277
2021-04-25,부산,25,23,2,4914
2021-04-25,서울,154,152,2,37010
2021-04-25,합계,499,469,30,119386
2021-04-24,검역,30,0,30,3402
2021-04-24,제주,3,3,0,696
2021-04-24,경남,45,44,1,3728
2021-04-24,경북,24,23,1,3981
2021-04-24,전남,9,9,0,1039
2021-04-24,전북,7,7,0,1882
2021-04-24,충남,6,6,0,2946
2021-04-24,충북,15,15,0,2558
2021-04-24,강원,10,9,1,2642
2021-04-24,경기,191,187,4,33324
2021-04-24,세종,0,0,0,351
2021-04-24,울산,43,43,0,1708
2021-04-24,대전,6,6,0,1673
2021-04-24,광주,8,8,0,2364
2021-04-24,인천,15,15,0,5578
2021-04-24,대구,14,13,1,9270
2021-04-24,부산,43,43,0,4889
2021-04-24,서울,175,172,3,36856
2021-04-24,합계,644,603,41,118887
2021-04-23,검역,11,0,11,3372
2021-04-23,제주,3,3,0,693
2021-04-23,경남,52,52,0,3683
2021-04-23,경북,32,30,2,3957
2021-04-23,전남,1,1,0,1030
2021-04-23,전북,9,6,3,1875
2021-04-23,충남,14,13,1,2940
2021-04-23,충북,15,13,2,2543
2021-04-23,강원,9,9,0,2632
2021-04-23,경기,244,240,4,33133
2021-04-23,세종,1,1,0,351
2021-04-23,울산,50,50,0,1665
2021-04-23,대전,10,10,0,1667
2021-04-23,광주,15,15,0,2356
2021-04-23,인천,18,17,1,5563
2021-04-23,대구,4,4,0,9256
2021-04-23,부산,44,44,0,4846
2021-04-23,서울,253,251,2,36681
2021-04-23,합계,785,760,25,118243
2021-04-22,검역,23,0,23,3361
2021-04-22,제주,3,3,0,690
2021-04-22,경남,63,63,0,3631
2021-04-22,경북,22,22,0,3925
2021-04-22,전남,6,6,0,1029
2021-04-22,전북,9,8,1,1866
2021-04-22,충남,10,10,0,2926
2021-04-22,충북,30,29,1,2528
2021-04-22,강원,15,15,0,2623
2021-04-22,경기,298,290,8,32889
2021-04-22,세종,3,3,0,350
2021-04-22,울산,38,38,0,1615
2021-04-22,대전,2,2,0,1657
2021-04-22,광주,16,16,0,2341
2021-04-22,인천,10,10,0,5545
2021-04-22,대구,12,12,0,9252
2021-04-22,부산,33,33,0,4802
2021-04-22,서울,204,198,6,36428
2021-04-22,합계,797,758,39,117458
2021-04-21,검역,5,0,5,3338
2021-04-21,제주,4,4,0,687
2021-04-21,경남,58,58,0,3568
2021-04-21,경북,23,23,0,3903
2021-04-21,전남,8,7,1,1023
2021-04-21,전북,6,6,0,1857
2021-04-21,충남,6,4,2,2916
2021-04-21,충북,19,19,0,2498
2021-04-21,강원,24,23,1,2608
2021-04-21,경기,222,217,5,32591
2021-04-21,세종,1,1,0,347
2021-04-21,울산,32,32,0,1577
2021-04-21,대전,13,13,0,1655
2021-04-21,광주,9,9,0,2325
2021-04-21,인천,14,11,3,5535
2021-04-21,대구,24,24,0,9240
2021-04-21,부산,37,35,2,4769
2021-04-21,서울,230,229,1,36224
2021-04-21,합계,735,715,20,116661
2021-04-20,검역,13,0,13,3333
2021-04-20,제주,7,6,1,683
2021-04-20,경남,41,40,1,3510
2021-04-20,경북,16,15,1,3880
2021-04-20,전남,4,2,2,1015
2021-04-20,전북,8,8,0,1851
2021-04-20,충남,8,7,1,2910
2021-04-20,충북,20,19,1,2479
2021-04-20,강원,15,14,1,2584
2021-04-20,경기,234,225,9,32369
2021-04-20,세종,1,1,0,346
2021-04-20,울산,39,39,0,1545
2021-04-20,대전,17,17,0,1642
2021-04-20,광주,17,17,0,2316
2021-04-20,인천,15,13,2,5521
2021-04-20,대구,25,25,0,9216
2021-04-20,부산,33,33,0,4732
2021-04-20,서울,218,211,7,35994
2021-04-20,합계,731,692,39,115926
2021-04-19,검역,10,0,10,3320
2021-04-19,제주,1,1,0,676
2021-04-19,경남,29,29,0,3469
2021-04-19,경북,21,20,1,3864
2021-04-19,전남,4,4,0,1011
2021-04-19,전북,3,3,0,1843
2021-04-19,충남,16,16,0,2902
2021-04-19,충북,14,14,0,2459
2021-04-19,강원,18,18,0,2569
2021-04-19,경기,189,184,5,32135
2021-04-19,세종,1,1,0,345
2021-04-19,울산,21,21,0,1506
2021-04-19,대전,8,8,0,1625
2021-04-19,광주,4,4,0,2299
2021-04-19,인천,18,18,0,5506
2021-04-19,대구,15,12,3,9191
2021-04-19,부산,29,29,0,4699
2021-04-19,서울,148,147,1,35776
2021-04-19,합계,549,529,20,115195
2021-04-18,검역,8,0,8,3310
2021-04-18,제주,2,2,0,675
2021-04-18,경남,35,35,0,3440
2021-04-18,경북,19,17,2,3843
2021-04-18,전남,3,2,1,1007
2021-04-18,전북,16,16,0,1840
2021-04-18,충남,13,13,0,2886
2021-04-18,충북,10,9,1,2445
2021-04-18,강원,21,21,0,2551
2021-04-18,경기,146,142,4,31946
2021-04-18,세종,1,1,0,344
2021-04-18,울산,28,28,0,1485
2021-04-18,대전,21,21,0,1617
2021-04-18,광주,11,11,0,2295
2021-04-18,인천,11,10,1,5488
2021-04-18,대구,24,23,1,9176
2021-04-18,부산,26,25,1,4670
2021-04-18,서울,137,136,1,35628
2021-04-18,합계,532,512,20,114646
2021-04-17,검역,9,0,9,3302
2021-04-17,제주,1,1,0,673
2021-04-17,경남,67,67,0,3405
2021-04-17,경북,28,26,2,3824
2021-04-17,전남,2,2,0,1004
2021-04-17,전북,21,21,0,1824
2021-04-17,충남,22,19,3,2873
2021-04-17,충북,10,10,0,2435
2021-04-17,강원,19,19,0,2530
2021-04-17,경기,184,181,3,31800
2021-04-17,세종,2,2,0,343
2021-04-17,울산,21,20,1,1457
2021-04-17,대전,5,5,0,1596
2021-04-17,광주,13,12,1,2284
2021-04-17,인천,19,19,0,5477
2021-04-17,대구,13,13,0,9152
2021-04-17,부산,31,30,1,4644
2021-04-17,서울,205,202,3,35492
2021-04-17,합계,672,649,23,114115
2021-04-16,검역,7,0,7,3293
2021-04-16,제주,1,1,0,672
2021-04-16,경남,38,36,2,3338
2021-04-16,경북,29,28,1,3796
2021-04-16,전남,6,6,0,1002
2021-04-16,전북,16,15,1,1803
2021-04-16,충남,7,6,1,2851
2021-04-16,충북,12,11,1,2425
2021-04-16,강원,12,11,1,2511
2021-04-16,경기,209,204,5,31616
2021-04-16,세종,0,0,0,341
2021-04-16,울산,26,25,1,1436
2021-04-16,대전,4,4,0,1591
2021-04-16,광주,4,4,0,2271
2021-04-16,인천,23,23,0,5458
2021-04-16,대구,12,10,2,9139
2021-04-16,부산,35,33,2,4614
2021-04-16,서울,217,213,4,35287
2021-04-16,합계,658,630,28,113444
2021-04-15,검역,11,0,11,3286
2021-04-15,제주,3,3,0,671
2021-04-15,경남,44,44,0,3300
2021-04-15,경북,24,23,1,3767
2021-04-15,전남,6,6,0,996
2021-04-15,전북,15,15,0,1787
2021-04-15,충남,13,12,1,2844
2021-04-15,충북,9,9,0,2413
2021-04-15,강원,7,7,0,2499
2021-04-15,경기,221,216,5,31407
2021-04-15,세종,3,3,0,341
2021-04-15,울산,24,24,0,1410
2021-04-15,대전,6,6,0,1587
2021-04-15,광주,11,10,1,2267
2021-04-15,인천,12,11,1,5435
2021-04-15,대구,4,4,0,9127
2021-04-15,부산,44,44,0,4579
2021-04-15,서울,216,215,1,35070
2021-04-15,합계,673,652,21,112786
2021-04-14,검역,15,0,15,3275
2021-04-14,제주,3,1,2,668
2021-04-14,경남,24,22,2,3256
2021-04-14,경북,19,19,0,3743
2021-04-14,전남,11,11,0,990
2021-04-14,전북,16,15,1,1772
2021-04-14,충남,4,4,0,2831
2021-04-14,충북,20,19,1,2404
2021-04-14,강원,18,18,0,2492
2021-04-14,경기,224,222,2,31189
2021-04-14,세종,3,3,0,338
2021-04-14,울산,21,21,0,1386
2021-04-14,대전,10,10,0,1581
2021-04-14,광주,4,3,1,2256
2021-04-14,인천,17,16,1,5423
2021-04-14,대구,18,16,2,9123
2021-04-14,부산,54,54,0,4535
2021-04-14,서울,216,215,1,34854
2021-04-14,합계,698,670,28,112113
2021-04-13,검역,12,0,12,3260
2021-04-13,제주,2,1,1,665
2021-04-13,경남,27,27,0,3232
2021-04-13,경북,14,14,0,3724
2021-04-13,전남,1,1,0,979
2021-04-13,전북,11,10,1,1756
2021-04-13,충남,10,10,0,2827
2021-04-13,충북,29,29,0,2384
2021-04-13,강원,6,6,0,2474
2021-04-13,경기,238,238,0,30965
2021-04-13,세종,2,2,0,335
2021-04-13,울산,30,30,0,1365
2021-04-13,대전,11,11,0,1571
2021-04-13,광주,5,5,0,2252
2021-04-13,인천,26,26,0,5406
2021-04-13,대구,11,11,0,9105
2021-04-13,부산,49,48,1,4481
2021-04-13,서울,246,244,2,34637
2021-04-13,합계,730,713,17,111418
2021-04-12,검역,5,0,5,3248
2021-04-12,제주,0,0,0,663
2021-04-12,경남,15,15,0,3205
2021-04-12,경북,10,10,0,3710
2021-04-12,전남,6,6,0,978
2021-04-12,전북,25,25,0,1745
2021-04-12,충남,14,14,0,2817
2021-04-12,충북,8,7,1,2355
2021-04-12,강원,13,12,1,2468
2021-04-12,경기,168,163,5,30727
2021-04-12,세종,2,2,0,333
2021-04-12,울산,32,32,0,1335
2021-04-12,대전,13,13,0,1560
2021-04-12,광주,9,9,0,2247
2021-04-12,인천,16,16,0,5380
2021-04-12,대구,9,9,0,9094
2021-04-12,부산,39,39,0,4432
2021-04-12,서울,157,155,2,34390
2021-04-12,합계,541,527,14,110687
2021-04-11,검역,8,0,8,3243
2021-04-11,제주,3,3,0,663
2021-04-11,경남,17,15,2,3190
2021-04-11,경북,15,15,0,3700
2021-04-11,전남,3,3,0,972
2021-04-11,전북,24,24,0,1720
2021-04-11,충남,18,16,2,2803
2021-04-11,충북,20,17,3,2347
2021-04-11,강원,6,4,2,2455
2021-04-11,경기,176,173,3,30559
2021-04-11,세종,5,5,0,331
2021-04-11,울산,34,31,3,1303
2021-04-11,대전,17,17,0,1547
2021-04-11,광주,4,4,0,2238
2021-04-11,인천,12,12,0,5364
2021-04-11,대구,16,15,1,9085
2021-04-11,부산,47,46,1,4393
2021-04-11,서울,161,159,2,34232
2021-04-11,합계,586,559,27,110145
2021-04-10,검역,8,0,8,3235
2021-04-10,제주,7,7,0,660
2021-04-10,경남,16,15,1,3173
2021-04-10,경북,13,12,1,3685
2021-04-10,전남,6,6,0,969
2021-04-10,전북,40,40,0,1696
2021-04-10,충남,22,22,0,2785
2021-04-10,충북,10,10,0,2327
2021-04-10,강원,5,5,0,2449
2021-04-10,경기,186,182,4,30383
2021-04-10,세종,1,1,0,326
2021-04-10,울산,11,10,1,1269
2021-04-10,대전,7,7,0,1530
2021-04-10,광주,0,0,0,2234
2021-04-10,인천,17,16,1,5352
2021-04-10,대구,6,6,0,9069
2021-04-10,부산,45,44,1,4346
2021-04-10,서울,213,210,3,34070
2021-04-10,합계,613,593,20,109558
2021-04-09,검역,4,0,4,3227
2021-04-09,제주,7,7,0,653
2021-04-09,경남,46,44,2,3157
2021-04-09,경북,26,26,0,3672
2021-04-09,전남,7,7,0,963
2021-04-09,전북,23,23,0,1656
2021-04-09,충남,15,15,0,2763
2021-04-09,충북,12,10,2,2317
2021-04-09,강원,6,6,0,2444
2021-04-09,경기,202,199,3,30197
2021-04-09,세종,4,4,0,325
2021-04-09,울산,25,25,0,1258
2021-04-09,대전,13,13,0,1523
2021-04-09,광주,1,1,0,2234
2021-04-09,인천,24,24,0,5335
2021-04-09,대구,5,4,1,9063
2021-04-09,부산,56,56,0,4301
2021-04-09,서울,200,197,3,33856
2021-04-09,합계,676,661,15,108944
2021-04-08,검역,7,0,7,3223
2021-04-08,제주,2,2,0,646
2021-04-08,경남,15,15,0,3111
2021-04-08,경북,7,7,0,3646
2021-04-08,전남,11,9,2,956
2021-04-08,전북,22,22,0,1633
2021-04-08,충남,18,17,1,2748
2021-04-08,충북,7,7,0,2305
2021-04-08,강원,3,3,0,2438
2021-04-08,경기,203,197,6,29995
2021-04-08,세종,5,5,0,321
2021-04-08,울산,9,9,0,1233
2021-04-08,대전,26,26,0,1510
2021-04-08,광주,5,5,0,2233
2021-04-08,인천,45,39,6,5311
2021-04-08,대구,17,16,1,9058
2021-04-08,부산,53,50,3,4245
2021-04-08,서울,214,213,1,33655
2021-04-08,합계,670,643,27,108267
2021-04-07,검역,7,0,7,3216
2021-04-07,제주,5,5,0,644
2021-04-07,경남,11,10,1,3096
2021-04-07,경북,11,11,0,3639
2021-04-07,전남,1,1,0,945
2021-04-07,전북,24,24,0,1611
2021-04-07,충남,20,18,2,2730
2021-04-07,충북,8,8,0,2298
2021-04-07,강원,7,6,1,2435
2021-04-07,경기,230,223,7,29792
2021-04-07,세종,7,7,0,316
2021-04-07,울산,13,13,0,1224
2021-04-07,대전,25,25,0,1484
2021-04-07,광주,0,0,0,2228
2021-04-07,인천,25,23,2,5266
2021-04-07,대구,9,9,0,9040
2021-04-07,부산,52,51,1,4192
2021-04-07,서울,243,238,5,33440
2021-04-07,합계,700,674,26,107596
2021-04-06,검역,4,0,4,3209
2021-04-06,제주,3,3,0,639
2021-04-06,경남,25,25,0,3085
2021-04-06,경북,9,9,0,3628
2021-04-06,전남,7,7,0,944
2021-04-06,전북,10,10,0,1587
2021-04-06,충남,12,11,1,2710
2021-04-06,충북,17,15,2,2290
2021-04-06,강원,16,16,0,2428
2021-04-06,경기,175,173,2,29562
2021-04-06,세종,1,1,0,309
2021-04-06,울산,26,26,0,1211
2021-04-06,대전,61,61,0,1459
2021-04-06,광주,2,2,0,2228
2021-04-06,인천,48,44,4,5241
2021-04-06,대구,15,15,0,9030
2021-04-06,부산,38,38,0,4140
2021-04-06,서울,197,195,2,33196
2021-04-06,합계,668,653,15,106896
2021-04-05,검역,5,0,5,3205
2021-04-05,제주,0,0,0,636
2021-04-05,경남,7,7,0,3060
2021-04-05,경북,25,25,0,3619
2021-04-05,전남,15,15,0,937
2021-04-05,전북,29,29,0,1577
2021-04-05,충남,6,4,2,2698
2021-04-05,충북,12,10,2,2273
2021-04-05,강원,15,15,0,2412
2021-04-05,경기,107,100,7,29387
2021-04-05,세종,0,0,0,308
2021-04-05,울산,4,4,0,1185
2021-04-05,대전,22,22,0,1398
2021-04-05,광주,6,6,0,2226
2021-04-05,인천,27,27,0,5193
2021-04-05,대구,16,16,0,9014
2021-04-05,부산,34,34,0,4102
2021-04-05,서울,146,144,2,32998
2021-04-05,합계,477,459,18,106228
2021-04-04,검역,10,0,10,3200
2021-04-04,제주,2,2,0,636
2021-04-04,경남,12,11,1,3053
2021-04-04,경북,20,20,0,3594
2021-04-04,전남,5,3,2,922
2021-04-04,전북,16,16,0,1548
2021-04-04,충남,14,14,0,2692
2021-04-04,충북,7,7,0,2261
2021-04-04,강원,14,14,0,2397
2021-04-04,경기,111,108,3,29280
2021-04-04,세종,4,4,0,308
2021-04-04,울산,1,1,0,1181
2021-04-04,대전,13,13,0,1376
2021-04-04,광주,0,0,0,2220
2021-04-04,인천,22,19,3,5166
2021-04-04,대구,22,22,0,8998
2021-04-04,부산,48,46,2,4068
2021-04-04,서울,151,148,3,32851
2021-04-04,합계,472,448,24,105751
2021-04-03,검역,10,0,10,3190
2021-04-03,제주,2,2,0,634
2021-04-03,경남,14,13,1,3041
2021-04-03,경북,16,13,3,3574
2021-04-03,전남,1,1,0,917
2021-04-03,전북,24,23,1,1532
2021-04-03,충남,12,10,2,2678
2021-04-03,충북,14,14,0,2254
2021-04-03,강원,6,6,0,2383
2021-04-03,경기,150,146,4,29169
2021-04-03,세종,3,3,0,304
2021-04-03,울산,11,11,0,1180
2021-04-03,대전,29,28,1,1363
2021-04-03,광주,4,4,0,2220
2021-04-03,인천,22,19,3,5144
2021-04-03,대구,15,15,0,8976
2021-04-03,부산,61,60,1,4020
2021-04-03,서울,148,145,3,32699
2021-04-03,합계,543,514,29,105278
2021-04-02,검역,9,0,9,3180
2021-04-02,제주,1,1,0,632
2021-04-02,경남,28,28,0,3027
2021-04-02,경북,17,16,1,3558
2021-04-02,전남,1,1,0,916
2021-04-02,전북,20,20,0,1508
2021-04-02,충남,10,7,3,2666
2021-04-02,충북,11,11,0,2240
2021-04-02,강원,17,16,1,2377
2021-04-02,경기,147,143,4,29019
2021-04-02,세종,10,10,0,301
2021-04-02,울산,3,3,0,1169
2021-04-02,대전,19,19,0,1334
2021-04-02,광주,3,2,1,2216
2021-04-02,인천,21,19,2,5122
2021-04-02,대구,10,10,0,8961
2021-04-02,부산,61,61,0,3959
2021-04-02,서울,154,153,1,32550
2021-04-02,합계,543,521,22,104735
2021-04-01,검역,11,0,11,3171
2021-04-01,제주,4,4,0,631
2021-04-01,경남,18,18,0,2999
2021-04-01,경북,30,28,2,3541
2021-04-01,전남,1,1,0,915
2021-04-01,전북,15,15,0,1488
2021-04-01,충남,10,8,2,2656
2021-04-01,충북,19,19,0,2229
2021-04-01,강원,10,10,0,2360
2021-04-01,경기,160,156,4,28872
2021-04-01,세종,8,8,0,291
2021-04-01,울산,7,7,0,1166
2021-04-01,대전,19,19,0,1315
2021-04-01,광주,1,1,0,2213
2021-04-01,인천,23,22,1,5101
2021-04-01,대구,17,17,0,8951
2021-04-01,부산,38,35,3,3898
2021-04-01,서울,166,164,2,32395
2021-04-01,합계,557,532,25,104192
2021-03-31,검역,2,0,2,3160
2021-03-31,제주,2,2,0,627
2021-03-31,경남,21,21,0,2981
2021-03-31,경북,7,6,1,3511
2021-03-31,전남,1,1,0,914
2021-03-31,전북,22,22,0,1473
2021-03-31,충남,15,15,0,2646
2021-03-31,충북,20,19,1,2210
2021-03-31,강원,20,20,0,2350
2021-03-31,경기,130,125,5,28712
2021-03-31,세종,13,13,0,283
2021-03-31,울산,5,5,0,1159
2021-03-31,대전,10,10,0,1296
2021-03-31,광주,3,1,2,2212
2021-03-31,인천,20,20,0,5078
2021-03-31,대구,7,7,0,8934
2021-03-31,부산,54,53,1,3860
2021-03-31,서울,195,193,2,32229
2021-03-31,합계,551,534,14,103635
2021-03-30,검역,7,0,7,3158
2021-03-30,제주,2,2,0,625
2021-03-30,경남,22,21,1,2960
2021-03-30,경북,6,6,0,3504
2021-03-30,전남,0,0,0,913
2021-03-30,전북,20,20,0,1451
2021-03-30,충남,8,8,0,2631
2021-03-30,충북,21,21,0,2190
2021-03-30,강원,16,16,0,2330
2021-03-30,경기,111,106,5,28582
2021-03-30,세종,17,17,0,270
2021-03-30,울산,11,11,0,1154
2021-03-30,대전,7,7,0,1286
2021-03-30,광주,2,2,0,2209
2021-03-30,인천,25,25,0,5058
2021-03-30,대구,15,15,0,8927
2021-03-30,부산,58,58,0,3806
2021-03-30,서울,154,152,2,32030
2021-03-30,합계,506,491,15,103084
2021-03-29,검역,3,0,3,3151
2021-03-29,제주,0,0,0,623
2021-03-29,경남,16,15,1,2938
2021-03-29,경북,5,4,1,3498
2021-03-29,전남,0,0,0,913
2021-03-29,전북,25,25,0,1431
2021-03-29,충남,5,4,1,2623
2021-03-29,충북,28,27,1,2169
2021-03-29,강원,13,13,0,2314
2021-03-29,경기,117,112,5,28471
2021-03-29,세종,2,2,0,253
2021-03-29,울산,3,3,0,1143
2021-03-29,대전,11,11,0,1279
2021-03-29,광주,1,1,0,2207
2021-03-29,인천,18,18,0,5033
2021-03-29,대구,12,12,0,8912
2021-03-29,부산,43,42,1,3748
2021-03-29,서울,145,140,5,31872
2021-03-29,합계,447,429,18,102578
2021-03-28,검역,4,0,4,3148
2021-03-28,제주,1,0,1,623
2021-03-28,경남,20,18,2,2922
2021-03-28,경북,3,3,0,3493
2021-03-28,전남,1,0,1,913
2021-03-28,전북,8,8,0,1406
2021-03-28,충남,1,1,0,2618
2021-03-28,충북,12,11,1,2141
2021-03-28,강원,6,6,0,2301
2021-03-28,경기,131,130,1,28354
2021-03-28,세종,0,0,0,251
2021-03-28,울산,3,3,0,1140
2021-03-28,대전,2,2,0,1268
2021-03-28,광주,2,2,0,2206
2021-03-28,인천,18,18,0,5015
2021-03-28,대구,10,9,1,8900
2021-03-28,부산,53,53,0,3705
2021-03-28,서울,107,105,2,31727
2021-03-28,합계,382,369,13,102131
2021-03-27,검역,9,0,9,3144
2021-03-27,제주,0,0,0,622
2021-03-27,경남,13,13,0,2902
2021-03-27,경북,7,7,0,3490
2021-03-27,전남,1,0,1,912
2021-03-27,전북,5,5,0,1398
2021-03-27,충남,8,8,0,2617
2021-03-27,충북,16,16,0,2129
2021-03-27,강원,19,19,0,2295
2021-03-27,경기,153,150,3,28223
2021-03-27,세종,0,0,0,251
2021-03-27,울산,4,4,0,1137
2021-03-27,대전,8,6,2,1266
2021-03-27,광주,2,2,0,2204
2021-03-27,인천,33,32,1,4997
2021-03-27,대구,10,9,1,8890
2021-03-27,부산,56,56,0,3652
2021-03-27,서울,138,135,3,31620
2021-03-27,합계,482,462,20,101749
2021-03-26,검역,3,0,3,3135
2021-03-26,제주,2,2,0,622
2021-03-26,경남,19,19,0,2889
2021-03-26,경북,11,10,1,3483
2021-03-26,전남,0,0,0,911
2021-03-26,전북,5,4,1,1393
2021-03-26,충남,2,2,0,2609
2021-03-26,충북,39,38,1,2113
2021-03-26,강원,36,35,1,2276
2021-03-26,경기,145,141,4,28070
2021-03-26,세종,1,1,0,251
2021-03-26,울산,5,3,2,1133
2021-03-26,대전,10,10,0,1258
2021-03-26,광주,5,5,0,2202
2021-03-26,인천,39,39,0,4964
2021-03-26,대구,23,22,1,8880
2021-03-26,부산,33,33,0,3596
2021-03-26,서울,127,126,1,31482
2021-03-26,합계,505,490,15,101267
2021-03-25,검역,3,0,3,3132
2021-03-25,제주,3,2,1,620
2021-03-25,경남,37,37,0,2870
2021-03-25,경북,13,12,1,3472
2021-03-25,전남,2,2,0,911
2021-03-25,전북,3,3,0,1388
2021-03-25,충남,3,2,1,2607
2021-03-25,충북,13,9,4,2074
2021-03-25,강원,24,24,0,2240
2021-03-25,경기,196,187,9,27925
2021-03-25,세종,0,0,0,250
2021-03-25,울산,0,0,0,1128
2021-03-25,대전,14,13,1,1248
2021-03-25,광주,3,2,1,2197
2021-03-25,인천,29,28,1,4925
2021-03-25,대구,14,14,0,8857
2021-03-25,부산,11,11,0,3563
2021-03-25,서울,121,120,1,31355
2021-03-25,합계,489,466,23,100762
2021-03-24,검역,5,0,5,3129
2021-03-24,제주,0,0,0,617
2021-03-24,경남,30,30,0,2833
2021-03-24,경북,10,9,1,3459
2021-03-24,전남,1,1,0,909
2021-03-24,전북,5,4,1,1385
2021-03-24,충남,4,4,0,2604
2021-03-24,충북,17,17,0,2061
2021-03-24,강원,27,27,0,2216
2021-03-24,경기,147,147,0,27729
2021-03-24,세종,0,0,0,250
2021-03-24,울산,0,0,0,1128
2021-03-24,대전,3,3,0,1234
2021-03-24,광주,5,4,1,2194
2021-03-24,인천,12,11,1,4896
2021-03-24,대구,17,17,0,8843
2021-03-24,부산,20,20,0,3552
2021-03-24,서울,124,122,2,31234
2021-03-24,합계,427,416,11,100273
2021-03-23,검역,8,0,8,3124
2021-03-23,제주,0,0,0,617
2021-03-23,경남,27,27,0,2803
2021-03-23,경북,12,12,0,3449
2021-03-23,전남,0,0,0,908
2021-03-23,전북,5,4,1,1380
2021-03-23,충남,0,0,0,2600
2021-03-23,충북,6,6,0,2044
2021-03-23,강원,18,18,0,2189
2021-03-23,경기,154,150,4,27582
2021-03-23,세종,0,0,0,250
2021-03-23,울산,2,1,1,1128
2021-03-23,대전,2,2,0,1231
2021-03-23,광주,2,2,0,2189
2021-03-23,인천,21,21,0,4884
2021-03-23,대구,17,17,0,8826
2021-03-23,부산,17,16,1,3532
2021-03-23,서울,134,132,2,31107
2021-03-23,합계,425,408,17,99843
2021-03-22,검역,8,0,8,3116
2021-03-22,제주,0,0,0,617
2021-03-22,경남,29,29,0,2776
2021-03-22,경북,20,19,1,3437
2021-03-22,전남,1,1,0,908
2021-03-22,전북,7,7,0,1375
2021-03-22,충남,8,7,1,2600
2021-03-22,충북,6,6,0,2038
2021-03-22,강원,9,9,0,2171
2021-03-22,경기,124,120,4,27428
2021-03-22,세종,0,0,0,250
2021-03-22,울산,8,8,0,1126
2021-03-22,대전,4,4,0,1229
2021-03-22,광주,1,1,0,2187
2021-03-22,인천,13,12,1,4863
2021-03-22,대구,3,3,0,8809
2021-03-22,부산,8,8,0,3515
2021-03-22,서울,94,94,0,30973
2021-03-22,합계,343,328,15,99418
2021-03-21,검역,7,0,7,3108
2021-03-21,제주,1,1,0,617
2021-03-21,경남,37,37,0,2747
2021-03-21,경북,11,10,1,3417
2021-03-21,전남,2,2,0,907
2021-03-21,전북,7,7,0,1368
2021-03-21,충남,11,11,0,2592
2021-03-21,충북,5,5,0,2032
2021-03-21,강원,21,21,0,2162
2021-03-21,경기,151,143,8,27304
2021-03-21,세종,0,0,0,250
2021-03-21,울산,1,1,0,1118
2021-03-21,대전,0,0,0,1225
2021-03-21,광주,2,2,0,2186
2021-03-21,인천,10,10,0,4850
2021-03-21,대구,14,14,0,8806
2021-03-21,부산,26,24,2,3507
2021-03-21,서울,103,102,1,30873
2021-03-21,합계,409,390,19,99069
2021-03-20,검역,9,0,9,3101
2021-03-20,제주,1,1,0,616
2021-03-20,경남,54,54,0,2710
2021-03-20,경북,5,5,0,3406
2021-03-20,전남,0,0,0,905
2021-03-20,전북,11,10,1,1361
2021-03-20,충남,5,5,0,2581
2021-03-20,충북,10,10,0,2027
2021-03-20,강원,14,13,1,2141
2021-03-20,경기,157,155,2,27153
2021-03-20,세종,0,0,0,250
2021-03-20,울산,7,7,0,1117
2021-03-20,대전,1,1,0,1225
2021-03-20,광주,2,2,0,2184
2021-03-20,인천,22,20,2,4840
2021-03-20,대구,14,12,2,8792
2021-03-20,부산,19,18,1,3481
2021-03-20,서울,125,124,1,30764
2021-03-20,합계,456,437,19,98654
2021-03-19,검역,4,0,4,3092
2021-03-19,제주,1,1,0,615
2021-03-19,경남,31,31,0,2656
2021-03-19,경북,11,11,0,3401
2021-03-19,전남,0,0,0,905
2021-03-19,전북,16,14,2,1350
2021-03-19,충남,6,5,1,2576
2021-03-19,충북,8,8,0,2017
2021-03-19,강원,17,17,0,2127
2021-03-19,경기,189,187,2,26996
2021-03-19,세종,0,0,0,250
2021-03-19,울산,3,3,0,1110
2021-03-19,대전,8,8,0,1224
2021-03-19,광주,1,0,1,2182
2021-03-19,인천,12,11,1,4818
2021-03-19,대구,16,16,0,8778
2021-03-19,부산,9,9,0,3462
2021-03-19,서울,115,114,1,30639
2021-03-19,합계,447,435,12,98204
2021-03-18,검역,7,0,7,3088
2021-03-18,제주,0,0,0,614
2021-03-18,경남,42,42,0,2625
2021-03-18,경북,4,4,0,3390
2021-03-18,전남,0,0,0,905
2021-03-18,전북,15,15,0,1334
2021-03-18,충남,5,3,2,2570
2021-03-18,충북,8,6,2,2009
2021-03-18,강원,31,30,1,2110
2021-03-18,경기,157,153,4,26807
2021-03-18,세종,0,0,0,250
2021-03-18,울산,3,2,1,1107
2021-03-18,대전,7,7,0,1216
2021-03-18,광주,2,2,0,2181
2021-03-18,인천,24,23,1,4806
2021-03-18,대구,5,4,1,8762
2021-03-18,부산,7,6,1,3453
2021-03-18,서울,146,144,2,30524
2021-03-18,합계,463,441,22,97751
2021-03-17,검역,9,0,9,3081
2021-03-17,제주,2,1,1,614
2021-03-17,경남,35,35,0,2583
2021-03-17,경북,5,5,0,3386
2021-03-17,전남,0,0,0,905
2021-03-17,전북,15,15,0,1319
2021-03-17,충남,14,13,1,2565
2021-03-17,충북,8,8,0,2001
2021-03-17,강원,23,23,0,2079
2021-03-17,경기,159,155,4,26650
2021-03-17,세종,1,1,0,250
2021-03-17,울산,5,5,0,1104
2021-03-17,대전,2,2,0,1209
2021-03-17,광주,1,0,1,2179
2021-03-17,인천,21,20,1,4782
2021-03-17,대구,14,13,1,8757
2021-03-17,부산,7,7,0,3446
2021-03-17,서울,124,124,0,30378
2021-03-17,합계,445,427,18,97288
2021-03-16,검역,9,0,9,3072
2021-03-16,제주,1,1,0,612
2021-03-16,경남,45,45,0,2548
2021-03-16,경북,4,4,0,3381
2021-03-16,전남,0,0,0,905
2021-03-16,전북,21,21,0,1304
2021-03-16,충남,6,6,0,2551
2021-03-16,충북,12,12,0,1993
2021-03-16,강원,10,10,0,2056
2021-03-16,경기,186,182,4,26491
2021-03-16,세종,3,2,1,249
2021-03-16,울산,4,3,1,1099
2021-03-16,대전,1,1,0,1207
2021-03-16,광주,1,0,1,2178
2021-03-16,인천,21,21,0,4761
2021-03-16,대구,14,14,0,8743
2021-03-16,부산,11,10,1,3439
2021-03-16,서울,120,120,0,30254
2021-03-16,합계,469,452,17,96843
2021-03-15,검역,7,0,7,3063
2021-03-15,제주,2,2,0,611
2021-03-15,경남,65,64,1,2503
2021-03-15,경북,4,4,0,3377
2021-03-15,전남,1,1,0,905
2021-03-15,전북,7,6,1,1283
2021-03-15,충남,4,4,0,2545
2021-03-15,충북,3,3,0,1981
2021-03-15,강원,13,12,1,2046
2021-03-15,경기,148,146,2,26305
2021-03-15,세종,0,0,0,246
2021-03-15,울산,3,3,0,1095
2021-03-15,대전,1,1,0,1206
2021-03-15,광주,2,1,1,2177
2021-03-15,인천,14,14,0,4740
2021-03-15,대구,3,3,0,8729
2021-03-15,부산,7,6,1,3428
2021-03-15,서울,79,75,4,30134
2021-03-15,합계,363,345,18,96374
2021-03-14,검역,7,0,7,3056
2021-03-14,제주,3,3,0,609
2021-03-14,경남,31,31,0,2438
2021-03-14,경북,3,3,0,3373
2021-03-14,전남,1,0,1,904
2021-03-14,전북,5,4,1,1276
2021-03-14,충남,6,5,1,2541
2021-03-14,충북,9,9,0,1978
2021-03-14,강원,10,10,0,2033
2021-03-14,경기,161,161,0,26157
2021-03-14,세종,2,2,0,246
2021-03-14,울산,2,1,1,1092
2021-03-14,대전,2,2,0,1205
2021-03-14,광주,1,1,0,2175
2021-03-14,인천,18,18,0,4726
2021-03-14,대구,5,4,1,8726
2021-03-14,부산,4,4,0,3421
2021-03-14,서울,109,109,0,30055
2021-03-14,합계,379,367,12,96011
2021-03-13,검역,6,0,6,3049
2021-03-13,제주,1,1,0,606
2021-03-13,경남,53,52,1,2407
2021-03-13,경북,9,7,2,3370
2021-03-13,전남,2,2,0,903
2021-03-13,전북,7,5,2,1271
2021-03-13,충남,2,1,1,2535
2021-03-13,충북,7,7,0,1969
2021-03-13,강원,16,16,0,2023
2021-03-13,경기,203,199,4,25996
2021-03-13,세종,0,0,0,244
2021-03-13,울산,1,1,0,1090
2021-03-13,대전,0,0,0,1203
2021-03-13,광주,1,1,0,2174
2021-03-13,인천,20,19,1,4708
2021-03-13,대구,6,4,2,8721
2021-03-13,부산,13,13,0,3417
2021-03-13,서울,112,108,4,29949
2021-03-13,합계,459,436,23,95635
2021-03-12,검역,6,0,6,3043
2021-03-12,제주,1,1,0,605
2021-03-12,경남,62,61,1,2354
2021-03-12,경북,14,12,2,3361
2021-03-12,전남,1,1,0,901
2021-03-12,전북,2,2,0,1264
2021-03-12,충남,9,9,0,2533
2021-03-12,충북,16,16,0,1962
2021-03-12,강원,18,18,0,2007
2021-03-12,경기,164,160,4,25793
2021-03-12,세종,0,0,0,244
2021-03-12,울산,1,1,0,1089
2021-03-12,대전,1,1,0,1203
2021-03-12,광주,3,2,1,2173
2021-03-12,인천,26,26,0,4688
2021-03-12,대구,9,9,0,8715
2021-03-12,부산,17,17,0,3404
2021-03-12,서울,140,138,2,29837
2021-03-12,합계,490,474,16,95176
2021-03-11,검역,6,0,6,3037
2021-03-11,제주,2,2,0,604
2021-03-11,경남,56,56,0,2292
2021-03-11,경북,9,9,0,3347
2021-03-11,전남,4,4,0,900
2021-03-11,전북,4,4,0,1262
2021-03-11,충남,3,3,0,2524
2021-03-11,충북,27,27,0,1946
2021-03-11,강원,12,12,0,1989
2021-03-11,경기,166,157,9,25629
2021-03-11,세종,2,2,0,244
2021-03-11,울산,5,4,1,1088
2021-03-11,대전,0,0,0,1202
2021-03-11,광주,2,2,0,2170
2021-03-11,인천,31,29,2,4662
2021-03-11,대구,4,4,0,8706
2021-03-11,부산,15,14,1,3387
2021-03-11,서울,140,138,2,29697
2021-03-11,합계,488,467,21,94686
2021-03-10,검역,10,0,10,3031
2021-03-10,제주,2,2,0,602
2021-03-10,경남,8,7,1,2236
2021-03-10,경북,11,10,1,3338
2021-03-10,전남,3,3,0,896
2021-03-10,전북,8,7,1,1258
2021-03-10,충남,4,4,0,2521
2021-03-10,충북,6,6,0,1919
2021-03-10,강원,30,30,0,1977
2021-03-10,경기,184,178,6,25463
2021-03-10,세종,0,0,0,242
2021-03-10,울산,23,23,0,1083
2021-03-10,대전,1,1,0,1202
2021-03-10,광주,1,1,0,2168
2021-03-10,인천,18,18,0,4631
2021-03-10,대구,4,4,0,8702
2021-03-10,부산,14,13,1,3372
2021-03-10,서울,138,137,1,29557
2021-03-10,합계,465,444,21,94198
2021-03-09,검역,5,0,5,3021
2021-03-09,제주,2,2,0,600
2021-03-09,경남,7,7,0,2228
2021-03-09,경북,4,4,0,3327
2021-03-09,전남,3,3,0,893
2021-03-09,전북,5,5,0,1250
2021-03-09,충남,6,6,0,2517
2021-03-09,충북,21,18,3,1913
2021-03-09,강원,20,20,0,1947
2021-03-09,경기,203,199,4,25279
2021-03-09,세종,0,0,0,242
2021-03-09,울산,21,21,0,1060
2021-03-09,대전,3,3,0,1201
2021-03-09,광주,1,1,0,2167
2021-03-09,인천,23,23,0,4613
2021-03-09,대구,1,1,0,8698
2021-03-09,부산,7,7,0,3358
2021-03-09,서울,138,132,6,29419
2021-03-09,합계,470,452,18,93733
2021-03-08,검역,4,0,4,3016
2021-03-08,제주,2,2,0,598
2021-03-08,경남,1,1,0,2221
2021-03-08,경북,2,2,0,3323
2021-03-08,전남,3,2,1,890
2021-03-08,전북,8,7,1,1245
2021-03-08,충남,15,14,1,2511
2021-03-08,충북,21,21,0,1892
2021-03-08,강원,13,13,0,1927
2021-03-08,경기,188,181,7,25076
2021-03-08,세종,0,0,0,242
2021-03-08,울산,11,11,0,1039
2021-03-08,대전,1,1,0,1198
2021-03-08,광주,33,32,1,2166
2021-03-08,인천,20,20,0,4590
2021-03-08,대구,3,3,0,8697
2021-03-08,부산,19,19,0,3351
2021-03-08,서울,102,98,4,29281
2021-03-08,합계,446,427,19,93263
2021-03-07,검역,5,0,5,3012
2021-03-07,제주,3,3,0,596
2021-03-07,경남,1,0,1,2220
2021-03-07,경북,3,2,1,3321
2021-03-07,전남,6,6,0,887
2021-03-07,전북,4,4,0,1237
2021-03-07,충남,14,14,0,2496
2021-03-07,충북,20,20,0,1871
2021-03-07,강원,10,10,0,1914
2021-03-07,경기,128,128,0,24888
2021-03-07,세종,1,1,0,242
2021-03-07,울산,3,3,0,1028
2021-03-07,대전,0,0,0,1197
2021-03-07,광주,15,14,1,2133
2021-03-07,인천,15,15,0,4570
2021-03-07,대구,6,6,0,8694
2021-03-07,부산,12,12,0,3332
2021-03-07,서울,100,97,3,29179
2021-03-07,합계,346,335,11,92817
2021-03-06,검역,5,0,5,3007
2021-03-06,제주,4,4,0,593
2021-03-06,경남,3,3,0,2219
2021-03-06,경북,13,11,2,3318
2021-03-06,전남,6,6,0,881
2021-03-06,전북,5,5,0,1233
2021-03-06,충남,6,6,0,2482
2021-03-06,충북,9,8,1,1851
2021-03-06,강원,10,10,0,1904
2021-03-06,경기,172,169,3,24760
2021-03-06,세종,2,2,0,241
2021-03-06,울산,2,2,0,1025
2021-03-06,대전,1,1,0,1197
2021-03-06,광주,4,4,0,2118
2021-03-06,인천,28,27,1,4555
2021-03-06,대구,8,8,0,8688
2021-03-06,부산,6,6,0,3320
2021-03-06,서울,132,127,5,29079
2021-03-06,합계,416,399,17,92471
2021-03-05,검역,6,0,6,3002
2021-03-05,제주,5,5,0,589
2021-03-05,경남,5,5,0,2216
2021-03-05,경북,13,13,0,3305
2021-03-05,전남,3,3,0,875
2021-03-05,전북,4,4,0,1228
2021-03-05,충남,7,7,0,2476
2021-03-05,충북,22,22,0,1842
2021-03-05,강원,7,7,0,1894
2021-03-05,경기,173,172,1,24588
2021-03-05,세종,2,1,1,239
2021-03-05,울산,4,4,0,1023
2021-03-05,대전,0,0,0,1196
2021-03-05,광주,3,1,2,2114
2021-03-05,인천,20,19,1,4527
2021-03-05,대구,4,3,1,8680
2021-03-05,부산,12,12,0,3314
2021-03-05,서울,128,126,2,28947
2021-03-05,합계,418,404,14,92055
2021-03-04,검역,4,0,4,2996
2021-03-04,제주,2,2,0,584
2021-03-04,경남,3,3,0,2211
2021-03-04,경북,6,4,2,3292
2021-03-04,전남,0,0,0,872
2021-03-04,전북,3,3,0,1224
2021-03-04,충남,9,8,1,2469
2021-03-04,충북,19,19,0,1820
2021-03-04,강원,4,4,0,1887
2021-03-04,경기,173,168,5,24415
2021-03-04,세종,1,1,0,237
2021-03-04,울산,3,0,3,1019
2021-03-04,대전,0,0,0,1196
2021-03-04,광주,6,5,1,2111
2021-03-04,인천,13,12,1,4507
2021-03-04,대구,3,3,0,8676
2021-03-04,부산,20,20,0,3302
2021-03-04,서울,129,129,0,28819
2021-03-04,합계,398,381,17,91637
2021-03-03,검역,6,0,6,2992
2021-03-03,제주,3,3,0,582
2021-03-03,경남,10,9,1,2208
2021-03-03,경북,7,5,2,3286
2021-03-03,전남,1,1,0,872
2021-03-03,전북,6,6,0,1221
2021-03-03,충남,4,2,2,2460
2021-03-03,충북,12,12,0,1801
2021-03-03,강원,6,6,0,1883
2021-03-03,경기,186,177,9,24242
2021-03-03,세종,0,0,0,236
2021-03-03,울산,0,0,0,1016
2021-03-03,대전,3,3,0,1196
2021-03-03,광주,6,6,0,2105
2021-03-03,인천,18,18,0,4494
2021-03-03,대구,20,19,1,8673
2021-03-03,부산,18,17,1,3282
2021-03-03,서울,118,117,1,28690
2021-03-03,합계,424,401,23,91239
2021-03-02,검역,2,0,2,2986
2021-03-02,제주,4,4,0,579
2021-03-02,경남,5,4,1,2198
2021-03-02,경북,6,5,1,3279
2021-03-02,전남,3,3,0,871
2021-03-02,전북,5,5,0,1215
2021-03-02,충남,4,4,0,2456
2021-03-02,충북,19,19,0,1789
2021-03-02,강원,6,6,0,1877
2021-03-02,경기,227,218,9,24056
2021-03-02,세종,4,4,0,236
2021-03-02,울산,1,1,0,1016
2021-03-02,대전,2,2,0,1193
2021-03-02,광주,3,3,0,2099
2021-03-02,인천,20,19,1,4476
2021-03-02,대구,6,5,1,8653
2021-03-02,부산,8,8,0,3264
2021-03-02,서울,119,116,3,28572
2021-03-02,합계,444,426,18,90815
2021-03-01,검역,9,0,9,2984
2021-03-01,제주,5,5,0,575
2021-03-01,경남,5,3,2,2193
2021-03-01,경북,7,4,3,3273
2021-03-01,전남,7,7,0,868
2021-03-01,전북,9,9,0,1210
2021-03-01,충남,4,4,0,2452
2021-03-01,충북,6,5,1,1770
2021-03-01,강원,2,2,0,1871
2021-03-01,경기,116,111,5,23829
2021-03-01,세종,5,5,0,232
2021-03-01,울산,0,0,0,1015
2021-03-01,대전,1,1,0,1191
2021-03-01,광주,4,4,0,2096
2021-03-01,인천,11,10,1,4456
2021-03-01,대구,14,12,2,8647
2021-03-01,부산,17,17,0,3256
2021-03-01,서울,122,120,2,28454
2021-03-01,합계,344,319,25,90372
2021-02-28,검역,5,0,5,2975
2021-02-28,제주,0,0,0,570
2021-02-28,경남,5,4,1,2188
2021-02-28,경북,13,10,3,3266
2021-02-28,전남,2,2,0,861
2021-02-28,전북,10,10,0,1201
2021-02-28,충남,4,2,2,2448
2021-02-28,충북,8,8,0,1764
2021-02-28,강원,5,5,0,1869
2021-02-28,경기,159,156,4,23714
2021-02-28,세종,1,1,0,227
2021-02-28,울산,2,2,0,1015
2021-02-28,대전,0,0,0,1190
2021-02-28,광주,8,6,2,2092
2021-02-28,인천,14,14,0,4445
2021-02-28,대구,10,10,0,8633
2021-02-28,부산,16,16,0,3239
2021-02-28,서울,92,92,0,28331
2021-02-28,합계,355,338,17,90028
2021-02-27,검역,9,0,9,2970
2021-02-27,제주,1,1,0,570
2021-02-27,경남,2,2,0,2183
2021-02-27,경북,4,3,1,3253
2021-02-27,전남,0,0,0,859
2021-02-27,전북,7,7,0,1191
2021-02-27,충남,7,4,3,2444
2021-02-27,충북,10,10,0,1756
2021-02-27,강원,4,3,1,1864
2021-02-27,경기,141,138,3,23553
2021-02-27,세종,6,6,0,226
2021-02-27,울산,5,5,0,1013
2021-02-27,대전,1,1,0,1190
2021-02-27,광주,14,14,0,2084
2021-02-27,인천,13,13,0,4431
2021-02-27,대구,6,5,1,8623
2021-02-27,부산,5,4,1,3223
2021-02-27,서울,120,117,3,28239
2021-02-27,합계,355,333,22,89674
2021-02-26,검역,3,0,3,2961
2021-02-26,제주,1,1,0,569
2021-02-26,경남,1,1,0,2181
2021-02-26,경북,7,6,1,3249
2021-02-26,전남,5,4,1,859
2021-02-26,전북,20,20,0,1184
2021-02-26,충남,4,4,0,2437
2021-02-26,충북,8,8,0,1746
2021-02-26,강원,6,5,1,1860
2021-02-26,경기,169,166,3,23412
2021-02-26,세종,1,1,0,220
2021-02-26,울산,3,3,0,1008
2021-02-26,대전,2,2,0,1189
2021-02-26,광주,12,12,0,2070
2021-02-26,인천,27,27,0,4418
2021-02-26,대구,6,6,0,8617
2021-02-26,부산,9,9,0,3218
2021-02-26,서울,131,130,1,28119
2021-02-26,합계,415,405,10,89317
2021-02-25,검역,8,0,8,2958
2021-02-25,제주,0,0,0,568
2021-02-25,경남,6,5,1,2180
2021-02-25,경북,6,5,1,3242
2021-02-25,전남,5,5,0,854
2021-02-25,전북,16,15,1,1164
2021-02-25,충남,3,2,1,2433
2021-02-25,충북,10,10,0,1738
2021-02-25,강원,6,5,1,1854
2021-02-25,경기,141,135,6,23243
2021-02-25,세종,1,1,0,219
2021-02-25,울산,1,1,0,1005
2021-02-25,대전,6,6,0,1187
2021-02-25,광주,11,11,0,2058
2021-02-25,인천,15,14,1,4391
2021-02-25,대구,10,10,0,8612
2021-02-25,부산,11,10,1,3209
2021-02-25,서울,131,128,3,27988
2021-02-25,합계,387,363,24,88903
2021-02-24,검역,10,0,10,2950
2021-02-24,제주,5,5,0,568
2021-02-24,경남,2,2,0,2174
2021-02-24,경북,9,9,0,3236
2021-02-24,전남,11,11,0,849
2021-02-24,전북,5,5,0,1148
2021-02-24,충남,16,16,0,2430
2021-02-24,충북,4,4,0,1728
2021-02-24,강원,2,2,0,1848
2021-02-24,경기,138,132,6,23102
2021-02-24,세종,0,0,0,218
2021-02-24,울산,2,1,1,1004
2021-02-24,대전,0,0,0,1181
2021-02-24,광주,15,15,0,2047
2021-02-24,인천,22,22,0,4376
2021-02-24,대구,14,12,2,8601
2021-02-24,부산,18,18,0,3198
2021-02-24,서울,122,114,8,27857
2021-02-24,합계,395,368,27,88515
2021-02-23,검역,4,0,4,2940
2021-02-23,제주,2,2,0,563
2021-02-23,경남,8,7,1,2172
2021-02-23,경북,18,15,3,3227
2021-02-23,전남,1,1,0,838
2021-02-23,전북,8,8,0,1143
2021-02-23,충남,12,12,0,2414
2021-02-23,충북,1,1,0,1724
2021-02-23,강원,9,9,0,1846
2021-02-23,경기,143,137,6,22964
2021-02-23,세종,2,2,0,218
2021-02-23,울산,1,1,0,1002
2021-02-23,대전,2,2,0,1181
2021-02-23,광주,35,35,0,2032
2021-02-23,인천,18,17,1,4354
2021-02-23,대구,19,17,2,8587
2021-02-23,부산,13,13,0,3180
2021-02-23,서울,144,138,6,27735
2021-02-23,합계,440,417,23,88120
2021-02-22,검역,5,0,5,2936
2021-02-22,제주,0,0,0,561
2021-02-22,경남,5,5,0,2164
2021-02-22,경북,8,7,1,3209
2021-02-22,전남,6,6,0,837
2021-02-22,전북,7,7,0,1135
2021-02-22,충남,8,8,0,2402
2021-02-22,충북,4,4,0,1723
2021-02-22,강원,14,14,0,1837
2021-02-22,경기,127,122,5,22821
2021-02-22,세종,1,1,0,216
2021-02-22,울산,2,1,1,1001
2021-02-22,대전,1,0,1,1179
2021-02-22,광주,7,6,1,1997
2021-02-22,인천,14,12,2,4336
2021-02-22,대구,10,7,3,8568
2021-02-22,부산,12,12,0,3167
2021-02-22,서울,125,117,8,27591
2021-02-22,합계,356,329,27,87680
2021-02-21,검역,4,0,4,2931
2021-02-21,제주,0,0,0,561
2021-02-21,경남,6,5,1,2159
2021-02-21,경북,11,11,0,3201
2021-02-21,전남,3,3,0,831
2021-02-21,전북,4,4,0,1128
2021-02-21,충남,6,6,0,2394
2021-02-21,충북,7,7,0,1719
2021-02-21,강원,20,19,1,1823
2021-02-21,경기,121,116,5,22694
2021-02-21,세종,0,0,0,215
2021-02-21,울산,1,0,1,999
2021-02-21,대전,3,2,1,1178
2021-02-21,광주,5,4,1,1990
2021-02-21,인천,19,18,1,4322
2021-02-21,대구,4,4,0,8558
2021-02-21,부산,12,12,0,3155
2021-02-21,서울,106,102,4,27466
2021-02-21,합계,332,313,19,87324
2021-02-20,검역,8,0,8,2927
2021-02-20,제주,3,3,0,561
2021-02-20,경남,7,7,0,2153
2021-02-20,경북,7,6,1,3190
2021-02-20,전남,8,8,0,828
2021-02-20,전북,8,7,1,1124
2021-02-20,충남,10,10,0,2388
2021-02-20,충북,6,6,0,1712
2021-02-20,강원,6,6,0,1803
2021-02-20,경기,171,170,1,22573
2021-02-20,세종,1,1,0,215
2021-02-20,울산,4,4,0,998
2021-02-20,대전,0,0,0,1175
2021-02-20,광주,6,5,1,1985
2021-02-20,인천,21,21,0,4303
2021-02-20,대구,8,6,2,8554
2021-02-20,부산,12,11,1,3143
2021-02-20,서울,130,120,10,27360
2021-02-20,합계,416,391,25,86992
2021-02-19,검역,7,0,7,2919
2021-02-19,제주,2,2,0,558
2021-02-19,경남,8,8,0,2146
2021-02-19,경북,19,16,3,3183
2021-02-19,전남,10,10,0,820
2021-02-19,전북,8,8,0,1116
2021-02-19,충남,12,12,0,2378
2021-02-19,충북,16,16,0,1706
2021-02-19,강원,5,3,2,1797
2021-02-19,경기,170,161,9,22402
2021-02-19,세종,0,0,0,214
2021-02-19,울산,1,0,1,994
2021-02-19,대전,2,2,0,1175
2021-02-19,광주,5,1,4,1979
2021-02-19,인천,37,35,2,4282
2021-02-19,대구,9,9,0,8546
2021-02-19,부산,14,14,0,3131
2021-02-19,서울,123,119,4,27230
2021-02-19,합계,448,416,32,86576
2021-02-18,검역,10,0,10,2912
2021-02-18,제주,3,3,0,556
2021-02-18,경남,9,9,0,2138
2021-02-18,경북,22,22,0,3164
2021-02-18,전남,10,10,0,810
2021-02-18,전북,3,3,0,1108
2021-02-18,충남,24,21,3,2366
2021-02-18,충북,18,18,0,1690
2021-02-18,강원,7,5,2,1792
2021-02-18,경기,189,182,7,22232
2021-02-18,세종,1,1,0,214
2021-02-18,울산,12,12,0,993
2021-02-18,대전,4,4,0,1173
2021-02-18,광주,4,3,1,1974
2021-02-18,인천,38,37,1,4245
2021-02-18,대구,11,10,1,8537
2021-02-18,부산,16,16,0,3117
2021-02-18,서울,180,177,3,27107
2021-02-18,합계,561,533,28,86128
2021-02-17,검역,12,0,12,2902
2021-02-17,제주,5,5,0,553
2021-02-17,경남,7,7,0,2129
2021-02-17,경북,23,22,1,3142
2021-02-17,전남,4,4,0,800
2021-02-17,전북,6,5,1,1105
2021-02-17,충남,28,28,0,2342
2021-02-17,충북,17,16,1,1672
2021-02-17,강원,4,3,1,1785
2021-02-17,경기,241,237,4,22043
2021-02-17,세종,1,1,0,213
2021-02-17,울산,6,6,0,981
2021-02-17,대전,12,12,0,1169
2021-02-17,광주,16,12,4,1970
2021-02-17,인천,17,16,1,4207
2021-02-17,대구,9,9,0,8526
2021-02-17,부산,28,28,0,3101
2021-02-17,서울,185,179,6,26927
2021-02-17,합계,621,590,31,85567
2021-02-16,검역,6,0,6,2890
2021-02-16,제주,0,0,0,548
2021-02-16,경남,8,7,1,2122
2021-02-16,경북,15,14,1,3119
2021-02-16,전남,15,15,0,796
2021-02-16,전북,6,6,0,1099
2021-02-16,충남,75,74,1,2314
2021-02-16,충북,6,6,0,1655
2021-02-16,강원,3,3,0,1781
2021-02-16,경기,154,147,7,21802
2021-02-16,세종,2,2,0,212
2021-02-16,울산,9,9,0,975
2021-02-16,대전,7,7,0,1157
2021-02-16,광주,3,2,1,1954
2021-02-16,인천,21,21,0,4190
2021-02-16,대구,14,12,2,8517
2021-02-16,부산,19,18,1,3073
2021-02-16,서울,258,247,11,26742
2021-02-16,합계,621,590,31,84946
2021-02-15,검역,8,0,8,2884
2021-02-15,제주,1,1,0,548
2021-02-15,경남,8,6,2,2114
2021-02-15,경북,3,2,1,3104
2021-02-15,전남,2,2,0,781
2021-02-15,전북,5,5,0,1093
2021-02-15,충남,58,58,0,2239
2021-02-15,충북,7,7,0,1649
2021-02-15,강원,5,4,1,1778
2021-02-15,경기,134,129,5,21648
2021-02-15,세종,0,0,0,210
2021-02-15,울산,7,7,0,966
2021-02-15,대전,4,4,0,1150
2021-02-15,광주,2,2,0,1951
2021-02-15,인천,21,19,2,4169
2021-02-15,대구,12,11,1,8503
2021-02-15,부산,19,17,2,3054
2021-02-15,서울,161,155,6,26484
2021-02-15,합계,457,429,28,84325
2021-02-14,검역,6,0,6,2876
2021-02-14,제주,0,0,0,547
2021-02-14,경남,3,3,0,2106
2021-02-14,경북,8,8,0,3101
2021-02-14,전남,5,4,1,779
2021-02-14,전북,4,4,0,1088
2021-02-14,충남,9,9,0,2181
2021-02-14,충북,0,0,0,1642
2021-02-14,강원,1,1,0,1773
2021-02-14,경기,102,99,3,21514
2021-02-14,세종,0,0,0,210
2021-02-14,울산,4,3,1,959
2021-02-14,대전,8,6,2,1146
2021-02-14,광주,3,3,0,1949
2021-02-14,인천,12,9,3,4148
2021-02-14,대구,13,12,1,8491
2021-02-14,부산,15,15,0,3035
2021-02-14,서울,150,146,4,26323
2021-02-14,합계,343,322,21,83868
2021-02-13,검역,7,0,7,2870
2021-02-13,제주,0,0,0,547
2021-02-13,경남,6,6,0,2103
2021-02-13,경북,5,4,1,3093
2021-02-13,전남,2,1,1,774
2021-02-13,전북,6,5,1,1084
2021-02-13,충남,12,11,1,2172
2021-02-13,충북,5,5,0,1642
2021-02-13,강원,5,5,0,1772
2021-02-13,경기,80,77,3,21412
2021-02-13,세종,2,2,0,210
2021-02-13,울산,3,3,0,955
2021-02-13,대전,2,2,0,1138
2021-02-13,광주,2,2,0,1946
2021-02-13,인천,19,19,0,4136
2021-02-13,대구,3,3,0,8478
2021-02-13,부산,15,12,3,3020
2021-02-13,서울,152,147,5,26173
2021-02-13,합계,326,304,22,83525
2021-02-12,검역,5,0,5,2863
2021-02-12,제주,0,0,0,547
2021-02-12,경남,4,4,0,2097
2021-02-12,경북,5,4,1,3088
2021-02-12,전남,0,0,0,772
2021-02-12,전북,5,5,0,1078
2021-02-12,충남,15,14,1,2160
2021-02-12,충북,5,4,1,1637
2021-02-12,강원,2,2,0,1767
2021-02-12,경기,99,97,2,21332
2021-02-12,세종,5,5,0,208
2021-02-12,울산,2,2,0,952
2021-02-12,대전,5,5,0,1136
2021-02-12,광주,3,3,0,1944
2021-02-12,인천,30,29,1,4117
2021-02-12,대구,14,14,0,8475
2021-02-12,부산,27,26,1,3005
2021-02-12,서울,136,131,5,26021
2021-02-12,합계,362,345,17,83199
2021-02-11,검역,6,0,6,2858
2021-02-11,제주,4,4,0,547
2021-02-11,경남,4,4,0,2093
2021-02-11,경북,4,4,0,3083
2021-02-11,전남,4,4,0,772
2021-02-11,전북,2,2,0,1073
2021-02-11,충남,13,10,3,2145
2021-02-11,충북,6,6,0,1632
2021-02-11,강원,6,6,0,1765
2021-02-11,경기,105,103,2,21233
2021-02-11,세종,2,2,0,203
2021-02-11,울산,0,0,0,950
2021-02-11,대전,1,1,0,1131
2021-02-11,광주,6,6,0,1941
2021-02-11,인천,43,41,2,4087
2021-02-11,대구,12,11,1,8461
2021-02-11,부산,27,25,2,2978
2021-02-11,서울,158,155,3,25885
2021-02-11,합계,403,384,19,82837
2021-02-10,검역,15,0,15,2852
2021-02-10,제주,4,4,0,543
2021-02-10,경남,5,5,0,2089
2021-02-10,경북,1,1,0,3079
2021-02-10,전남,0,0,0,768
2021-02-10,전북,7,7,0,1071
2021-02-10,충남,1,1,0,2132
2021-02-10,충북,4,3,1,1626
2021-02-10,강원,11,11,0,1759
2021-02-10,경기,188,181,7,21128
2021-02-10,세종,0,0,0,201
2021-02-10,울산,2,2,0,950
2021-02-10,대전,3,2,1,1130
2021-02-10,광주,13,9,4,1935
2021-02-10,인천,25,25,0,4044
2021-02-10,대구,13,10,3,8449
2021-02-10,부산,29,29,0,2951
2021-02-10,서울,183,177,6,25727
2021-02-10,합계,504,467,37,82434
2021-02-09,검역,6,0,6,2837
2021-02-09,제주,0,0,0,539
2021-02-09,경남,9,9,0,2084
2021-02-09,경북,2,2,0,3078
2021-02-09,전남,2,1,1,768
2021-02-09,전북,2,2,0,1064
2021-02-09,충남,2,2,0,2131
2021-02-09,충북,2,2,0,1622
2021-02-09,강원,5,5,0,1748
2021-02-09,경기,169,157,12,20940
2021-02-09,세종,1,1,0,201
2021-02-09,울산,0,0,0,948
2021-02-09,대전,0,0,0,1127
2021-02-09,광주,14,14,0,1922
2021-02-09,인천,20,18,2,4019
2021-02-09,대구,16,14,2,8436
2021-02-09,부산,19,18,1,2922
2021-02-09,서울,175,169,6,25544
2021-02-09,합계,444,414,30,81930
2021-02-08,검역,10,0,10,2831
2021-02-08,제주,2,2,0,539
2021-02-08,경남,7,5,2,2075
2021-02-08,경북,5,4,1,3076
2021-02-08,전남,0,0,0,766
2021-02-08,전북,3,3,0,1062
2021-02-08,충남,5,5,0,2129
2021-02-08,충북,3,2,1,1620
2021-02-08,강원,3,3,0,1743
2021-02-08,경기,126,117,9,20771
2021-02-08,세종,1,1,0,200
2021-02-08,울산,3,3,0,948
2021-02-08,대전,2,2,0,1127
2021-02-08,광주,8,8,0,1908
2021-02-08,인천,16,14,2,3999
2021-02-08,대구,9,9,0,8420
2021-02-08,부산,9,9,0,2903
2021-02-08,서울,90,86,4,25369
2021-02-08,합계,302,273,29,81486
2021-02-07,검역,8,0,8,2820
2021-02-07,제주,0,0,0,537
2021-02-07,경남,4,4,0,2068
2021-02-07,경북,6,5,1,3071
2021-02-07,전남,0,0,0,766
2021-02-07,전북,0,0,0,1059
2021-02-07,충남,10,5,5,2124
2021-02-07,충북,0,0,0,1617
2021-02-07,강원,4,4,0,1740
2021-02-07,경기,82,78,4,20645
2021-02-07,세종,1,1,0,199
2021-02-07,울산,1,0,1,945
2021-02-07,대전,4,4,0,1125
2021-02-07,광주,7,7,0,1900
2021-02-07,인천,18,17,1,3983
2021-02-07,대구,21,20,1,8411
2021-02-07,부산,9,7,2,2894
2021-02-07,서울,112,111,1,25279
2021-02-07,합계,287,263,24,81183
2021-02-06,검역,27,0,27,2812
2021-02-06,제주,2,2,0,537
2021-02-06,경남,4,4,0,2064
2021-02-06,경북,1,1,0,3065
2021-02-06,전남,4,4,0,766
2021-02-06,전북,0,0,0,1059
2021-02-06,충남,14,8,6,2114
2021-02-06,충북,1,1,0,1617
2021-02-06,강원,6,5,1,1736
2021-02-06,경기,112,108,4,20562
2021-02-06,세종,1,1,0,198
2021-02-06,울산,1,0,1,944
2021-02-06,대전,6,6,0,1121
2021-02-06,광주,10,10,0,1893
2021-02-06,인천,17,15,2,3965
2021-02-06,대구,12,11,1,8390
2021-02-06,부산,9,8,1,2885
2021-02-06,서울,144,141,3,25167
2021-02-06,합계,371,325,46,80895
2021-02-05,검역,11,0,11,2785
2021-02-05,제주,6,6,0,535
2021-02-05,경남,12,10,2,2060
2021-02-05,경북,7,4,3,3064
2021-02-05,전남,1,1,0,762
2021-02-05,전북,4,1,3,1059
2021-02-05,충남,13,13,0,2100
2021-02-05,충북,2,2,0,1616
2021-02-05,강원,1,1,0,1730
2021-02-05,경기,114,108,6,20450
2021-02-05,세종,0,0,0,197
2021-02-05,울산,2,2,0,943
2021-02-05,대전,8,8,0,1115
2021-02-05,광주,12,12,0,1883
2021-02-05,인천,25,24,1,3948
2021-02-05,대구,18,18,0,8378
2021-02-05,부산,14,14,0,2876
2021-02-05,서울,143,142,1,25023
2021-02-05,합계,393,366,27,80524
2021-02-04,검역,7,0,7,2774
2021-02-04,제주,2,2,0,529
2021-02-04,경남,6,6,0,2048
2021-02-04,경북,7,6,1,3057
2021-02-04,전남,0,0,0,761
2021-02-04,전북,0,0,0,1055
2021-02-04,충남,13,11,2,2087
2021-02-04,충북,3,2,1,1614
2021-02-04,강원,5,5,0,1729
2021-02-04,경기,114,110,4,20336
2021-02-04,세종,0,0,0,197
2021-02-04,울산,0,0,0,941
2021-02-04,대전,0,0,0,1107
2021-02-04,광주,14,14,0,1871
2021-02-04,인천,26,25,1,3923
2021-02-04,대구,14,14,0,8360
2021-02-04,부산,33,33,0,2862
2021-02-04,서울,126,122,4,24880
2021-02-04,합계,370,351,19,80131
2021-02-03,검역,6,0,6,2767
2021-02-03,제주,3,2,1,527
2021-02-03,경남,8,7,1,2042
2021-02-03,경북,6,6,0,3050
2021-02-03,전남,2,2,0,761
2021-02-03,전북,1,1,0,1055
2021-02-03,충남,13,13,0,2074
2021-02-03,충북,4,4,0,1611
2021-02-03,강원,8,8,0,1724
2021-02-03,경기,134,128,6,20222
2021-02-03,세종,0,0,0,197
2021-02-03,울산,2,2,0,941
2021-02-03,대전,2,2,0,1107
2021-02-03,광주,12,12,0,1857
2021-02-03,인천,44,43,1,3897
2021-02-03,대구,8,7,1,8346
2021-02-03,부산,26,26,0,2829
2021-02-03,서울,172,166,6,24754
2021-02-03,합계,451,429,22,79761
2021-02-02,검역,17,0,17,2761
2021-02-02,제주,1,1,0,524
2021-02-02,경남,8,8,0,2034
2021-02-02,경북,12,10,2,3044
2021-02-02,전남,6,6,0,759
2021-02-02,전북,10,10,0,1054
2021-02-02,충남,36,35,1,2061
2021-02-02,충북,9,8,1,1607
2021-02-02,강원,6,5,1,1716
2021-02-02,경기,111,107,4,20088
2021-02-02,세종,1,1,0,197
2021-02-02,울산,0,0,0,939
2021-02-02,대전,7,7,0,1105
2021-02-02,광주,6,6,0,1845
2021-02-02,인천,21,18,3,3853
2021-02-02,대구,9,9,0,8338
2021-02-02,부산,19,18,1,2803
2021-02-02,서울,188,184,4,24582
2021-02-02,합계,467,433,34,79310
2021-02-01,검역,12,0,12,2744
2021-02-01,제주,1,0,1,523
2021-02-01,경남,11,9,2,2026
2021-02-01,경북,10,10,0,3032
2021-02-01,전남,3,2,1,753
2021-02-01,전북,2,2,0,1044
2021-02-01,충남,5,5,0,2025
2021-02-01,충북,18,18,0,1598
2021-02-01,강원,7,7,0,1710
2021-02-01,경기,82,70,12,19977
2021-02-01,세종,0,0,0,196
2021-02-01,울산,1,0,1,939
2021-02-01,대전,0,0,0,1098
2021-02-01,광주,24,23,1,1839
2021-02-01,인천,8,8,0,3832
2021-02-01,대구,12,10,2,8329
2021-02-01,부산,12,10,2,2784
2021-02-01,서울,128,121,7,24394
2021-02-01,합계,336,295,41,78843
2021-01-31,검역,6,0,6,2732
2021-01-31,제주,0,0,0,522
2021-01-31,경남,4,4,0,2015
2021-01-31,경북,5,4,1,3022
2021-01-31,전남,1,0,1,750
2021-01-31,전북,3,1,2,1042
2021-01-31,충남,4,3,1,2020
2021-01-31,충북,6,5,1,1580
2021-01-31,강원,8,8,0,1703
2021-01-31,경기,92,89,3,19895
2021-01-31,세종,0,0,0,196
2021-01-31,울산,1,0,1,938
2021-01-31,대전,1,0,1,1098
2021-01-31,광주,32,32,0,1815
2021-01-31,인천,11,11,0,3824
2021-01-31,대구,9,9,0,8317
2021-01-31,부산,15,15,0,2772
2021-01-31,서울,107,104,3,24266
2021-01-31,합계,305,285,20,78507
2021-01-30,검역,15,0,15,2726
2021-01-30,제주,1,1,0,522
2021-01-30,경남,18,18,0,2011
2021-01-30,경북,16,15,1,3017
2021-01-30,전남,1,1,0,749
2021-01-30,전북,2,2,0,1039
2021-01-30,충남,5,4,1,2016
2021-01-30,충북,1,1,0,1574
2021-01-30,강원,6,6,0,1695
2021-01-30,경기,113,107,6,19803
2021-01-30,세종,2,2,0,196
2021-01-30,울산,6,6,0,937
2021-01-30,대전,0,0,0,1097
2021-01-30,광주,17,16,1,1783
2021-01-30,인천,21,19,2,3813
2021-01-30,대구,10,9,1,8308
2021-01-30,부산,20,20,0,2757
2021-01-30,서울,101,96,3,24160
2021-01-30,합계,355,323,30,78203
2021-01-29,검역,15,0,15,2711
2021-01-29,제주,2,2,0,521
2021-01-29,경남,12,11,1,1993
2021-01-29,경북,22,21,1,3001
2021-01-29,전남,1,1,0,748
2021-01-29,전북,3,3,0,1037
2021-01-29,충남,9,8,1,2011
2021-01-29,충북,11,11,0,1573
2021-01-29,강원,3,3,0,1689
2021-01-29,경기,146,136,10,19690
2021-01-29,세종,0,0,0,194
2021-01-29,울산,2,1,1,931
2021-01-29,대전,2,1,1,1097
2021-01-29,광주,33,32,1,1766
2021-01-29,인천,15,15,0,3792
2021-01-29,대구,8,8,0,8298
2021-01-29,부산,20,18,2,2737
2021-01-29,서울,154,150,2,24061
2021-01-29,합계,456,421,35,77848
2021-01-28,검역,9,0,9,2698
2021-01-28,제주,1,1,0,519
2021-01-28,경남,15,15,0,1981
2021-01-28,경북,43,41,2,2979
2021-01-28,전남,5,5,0,747
2021-01-28,전북,6,4,2,1034
2021-01-28,충남,6,6,0,2002
2021-01-28,충북,9,9,0,1562
2021-01-28,강원,8,7,1,1686
2021-01-28,경기,135,129,6,19544
2021-01-28,세종,0,0,0,194
2021-01-28,울산,2,2,0,929
2021-01-28,대전,1,1,0,1095
2021-01-28,광주,54,54,0,1733
2021-01-28,인천,19,18,1,3777
2021-01-28,대구,10,10,0,8290
2021-01-28,부산,34,34,0,2717
2021-01-28,서울,112,109,3,23908
2021-01-28,합계,469,445,24,77395
2021-01-27,검역,7,0,7,2689
2021-01-27,제주,0,0,0,518
2021-01-27,경남,19,19,0,1966
2021-01-27,경북,43,43,0,2936
2021-01-27,전남,8,8,0,742
2021-01-27,전북,1,1,0,1028
2021-01-27,충남,4,4,0,1996
2021-01-27,충북,25,24,1,1553
2021-01-27,강원,6,6,0,1678
2021-01-27,경기,118,116,2,19408
2021-01-27,세종,1,0,1,194
2021-01-27,울산,6,5,1,927
2021-01-27,대전,4,4,0,1094
2021-01-27,광주,44,44,0,1679
2021-01-27,인천,41,40,1,3758
2021-01-27,대구,11,10,1,8280
2021-01-27,부산,54,53,1,2683
2021-01-27,서울,105,102,3,23797
2021-01-27,합계,497,479,18,76926
2021-01-26,검역,12,0,12,2682
2021-01-26,제주,0,0,0,518
2021-01-26,경남,21,20,1,1947
2021-01-26,경북,11,10,1,2893
2021-01-26,전남,12,12,0,734
2021-01-26,전북,13,11,2,1027
2021-01-26,충남,4,4,0,1992
2021-01-26,충북,8,8,0,1528
2021-01-26,강원,18,18,0,1672
2021-01-26,경기,150,137,13,19290
2021-01-26,세종,4,4,0,193
2021-01-26,울산,6,5,1,921
2021-01-26,대전,1,1,0,1090
2021-01-26,광주,112,112,0,1635
2021-01-26,인천,20,17,3,3717
2021-01-26,대구,6,6,0,8269
2021-01-26,부산,32,31,1,2629
2021-01-26,서울,129,120,9,23692
2021-01-26,합계,559,516,43,76429
2021-01-25,검역,6,0,6,2670
2021-01-25,제주,0,0,0,518
2021-01-25,경남,12,12,0,1926
2021-01-25,경북,8,8,0,2882
2021-01-25,전남,9,9,0,722
2021-01-25,전북,1,1,0,1014
2021-01-25,충남,6,6,0,1988
2021-01-25,충북,7,7,0,1520
2021-01-25,강원,43,42,1,1654
2021-01-25,경기,82,74,3,19141
2021-01-25,세종,2,2,0,189
2021-01-25,울산,0,0,0,915
2021-01-25,대전,4,4,0,1089
2021-01-25,광주,12,12,0,1523
2021-01-25,인천,18,16,2,3697
2021-01-25,대구,13,12,1,8263
2021-01-25,부산,27,27,0,2597
2021-01-25,서울,104,101,3,23563
2021-01-25,합계,350,334,16,75871
2021-01-24,검역,11,0,11,2664
2021-01-24,제주,0,0,0,518
2021-01-24,경남,11,11,0,1914
2021-01-24,경북,15,14,1,2874
2021-01-24,전남,3,3,0,713
2021-01-24,전북,0,0,0,1013
2021-01-24,충남,13,13,0,1982
2021-01-24,충북,8,8,0,1513
2021-01-24,강원,4,3,1,1611
2021-01-24,경기,76,72,4,19063
2021-01-24,세종,2,2,0,187
2021-01-24,울산,2,2,0,915
2021-01-24,대전,125,125,0,1085
2021-01-24,광주,16,15,1,1511
2021-01-24,인천,14,13,1,3679
2021-01-24,대구,15,14,1,8250
2021-01-24,부산,20,19,1,2570
2021-01-24,서울,102,91,11,23459
2021-01-24,합계,437,405,32,75521
2021-01-23,검역,9,0,9,2653
2021-01-23,제주,2,1,1,518
2021-01-23,경남,17,17,0,1903
2021-01-23,경북,8,7,1,2859
2021-01-23,전남,1,1,0,710
2021-01-23,전북,4,3,1,1013
2021-01-23,충남,9,9,0,1969
2021-01-23,충북,12,12,0,1505
2021-01-23,강원,11,11,0,1607
2021-01-23,경기,99,99,0,18987
2021-01-23,세종,11,11,0,185
2021-01-23,울산,2,1,1,913
2021-01-23,대전,0,0,0,960
2021-01-23,광주,17,17,0,1495
2021-01-23,인천,25,23,2,3665
2021-01-23,대구,12,11,1,8235
2021-01-23,부산,20,19,1,2550
2021-01-23,서울,133,127,6,23357
2021-01-23,합계,392,369,23,75084
2021-01-22,검역,12,0,12,2644
2021-01-22,제주,3,3,0,516
2021-01-22,경남,32,32,0,1886
2021-01-22,경북,18,18,0,2851
2021-01-22,전남,10,9,1,709
2021-01-22,전북,7,7,0,1009
2021-01-22,충남,17,17,0,1960
2021-01-22,충북,4,4,0,1493
2021-01-22,강원,6,5,1,1596
2021-01-22,경기,117,113,4,18888
2021-01-22,세종,1,1,0,174
2021-01-22,울산,2,2,0,911
2021-01-22,대전,1,1,0,960
2021-01-22,광주,7,6,1,1478
2021-01-22,인천,12,12,0,3640
2021-01-22,대구,22,21,1,8223
2021-01-22,부산,33,33,0,2530
2021-01-22,서울,127,119,8,23224
2021-01-22,합계,431,403,28,74692
2021-01-21,검역,9,0,9,2633
2021-01-21,제주,2,2,0,513
2021-01-21,경남,21,21,0,1854
2021-01-21,경북,15,12,3,2833
2021-01-21,전남,7,7,0,699
2021-01-21,전북,0,0,0,1002
2021-01-21,충남,7,7,0,1943
2021-01-21,충북,1,1,0,1489
2021-01-21,강원,9,8,1,1590
2021-01-21,경기,116,102,14,18771
2021-01-21,세종,0,0,0,173
2021-01-21,울산,3,2,1,909
2021-01-21,대전,1,1,0,959
2021-01-21,광주,2,2,0,1471
2021-01-21,인천,9,8,1,3628
2021-01-21,대구,6,5,1,8201
2021-01-21,부산,23,23,0,2497
2021-01-21,서울,115,113,2,23097
2021-01-21,합계,346,314,32,74262
2021-01-20,검역,6,0,6,2624
2021-01-20,제주,5,5,0,511
2021-01-20,경남,16,15,1,1833
2021-01-20,경북,8,8,0,2818
2021-01-20,전남,14,14,0,692
2021-01-20,전북,5,4,1,1002
2021-01-20,충남,10,10,0,1936
2021-01-20,충북,7,7,0,1488
2021-01-20,강원,8,6,2,1581
2021-01-20,경기,138,133,5,18655
2021-01-20,세종,1,1,0,173
2021-01-20,울산,3,2,1,906
2021-01-20,대전,0,0,0,958
2021-01-20,광주,6,5,1,1469
2021-01-20,인천,23,22,1,3619
2021-01-20,대구,7,7,0,8195
2021-01-20,부산,19,19,0,2474
2021-01-20,서울,125,122,3,22984
2021-01-20,합계,401,380,21,73918
2021-01-19,검역,1,0,1,2619
2021-01-19,제주,6,6,0,506
2021-01-19,경남,19,18,1,1817
2021-01-19,경북,7,7,0,2810
2021-01-19,전남,9,9,0,678
2021-01-19,전북,2,2,0,997
2021-01-19,충남,8,7,1,1926
2021-01-19,충북,3,2,1,1481
2021-01-19,강원,11,9,2,1573
2021-01-19,경기,139,126,13,18517
2021-01-19,세종,0,0,0,172
2021-01-19,울산,3,3,0,903
2021-01-19,대전,1,1,0,958
2021-01-19,광주,11,11,0,1463
2021-01-19,인천,16,14,2,3596
2021-01-19,대구,12,11,1,8188
2021-01-19,부산,13,12,1,2455
2021-01-19,서울,143,135,8,22859
2021-01-19,합계,404,373,31,73518
2021-01-18,검역,8,0,8,2618
2021-01-18,제주,1,1,0,500
2021-01-18,경남,11,11,0,1798
2021-01-18,경북,9,8,1,2803
2021-01-18,전남,6,6,0,669
2021-01-18,전북,3,2,1,995
2021-01-18,충남,8,7,1,1918
2021-01-18,충북,5,5,0,1478
2021-01-18,강원,17,16,1,1562
2021-01-18,경기,139,128,11,18378
2021-01-18,세종,3,3,0,172
2021-01-18,울산,8,5,3,900
2021-01-18,대전,7,7,0,957
2021-01-18,광주,8,7,1,1452
2021-01-18,인천,19,18,1,3580
2021-01-18,대구,16,15,1,8176
2021-01-18,부산,17,17,0,2442
2021-01-18,서울,101,95,6,22717
2021-01-18,합계,386,351,35,73115
2021-01-17,검역,10,0,10,2610
2021-01-17,제주,2,2,0,499
2021-01-17,경남,22,20,2,1787
2021-01-17,경북,18,18,0,2794
2021-01-17,전남,4,4,0,663
2021-01-17,전북,3,3,0,992
2021-01-17,충남,11,11,0,1910
2021-01-17,충북,9,8,1,1473
2021-01-17,강원,16,14,2,1545
2021-01-17,경기,105,103,2,18239
2021-01-17,세종,2,2,0,169
2021-01-17,울산,6,5,1,892
2021-01-17,대전,2,2,0,950
2021-01-17,광주,11,11,0,1444
2021-01-17,인천,13,13,0,3561
2021-01-17,대구,13,13,0,8160
2021-01-17,부산,10,9,1,2425
2021-01-17,서울,132,128,4,22616
2021-01-17,합계,389,366,23,72729
2021-01-16,검역,8,0,8,2600
2021-01-16,제주,0,0,0,497
2021-01-16,경남,18,18,0,1765
2021-01-16,경북,15,15,0,2776
2021-01-16,전남,15,15,0,659
2021-01-16,전북,5,5,0,989
2021-01-16,충남,7,6,1,1899
2021-01-16,충북,7,7,0,1464
2021-01-16,강원,4,4,0,1529
2021-01-16,경기,175,173,2,18134
2021-01-16,세종,1,1,0,167
2021-01-16,울산,18,15,3,886
2021-01-16,대전,3,3,0,948
2021-01-16,광주,15,14,1,1433
2021-01-16,인천,35,35,0,3548
2021-01-16,대구,15,15,0,8147
2021-01-16,부산,34,32,2,2415
2021-01-16,서울,145,142,3,22484
2021-01-16,합계,520,500,20,72340
2021-01-15,검역,8,0,8,2592
2021-01-15,제주,4,4,0,497
2021-01-15,경남,20,15,5,1747
2021-01-15,경북,20,19,1,2761
2021-01-15,전남,13,13,0,644
2021-01-15,전북,17,17,0,984
2021-01-15,충남,8,8,0,1892
2021-01-15,충북,6,6,0,1457
2021-01-15,강원,23,22,1,1525
2021-01-15,경기,168,163,5,17959
2021-01-15,세종,1,1,0,166
2021-01-15,울산,8,8,0,868
2021-01-15,대전,5,5,0,945
2021-01-15,광주,6,6,0,1418
2021-01-15,인천,33,30,3,3513
2021-01-15,대구,23,23,0,8132
2021-01-15,부산,61,59,2,2381
2021-01-15,서울,156,148,8,22339
2021-01-15,합계,580,547,33,71820
2021-01-14,검역,5,0,5,2584
2021-01-14,제주,1,1,0,493
2021-01-14,경남,22,21,1,1727
2021-01-14,경북,23,21,2,2741
2021-01-14,전남,14,14,0,632
2021-01-14,전북,6,6,0,967
2021-01-14,충남,6,3,3,1884
2021-01-14,충북,9,7,2,1451
2021-01-14,강원,13,13,0,1502
2021-01-14,경기,186,180,6,17791
2021-01-14,세종,4,4,0,165
2021-01-14,울산,6,6,0,860
2021-01-14,대전,3,3,0,940
2021-01-14,광주,6,5,1,1412
2021-01-14,인천,24,23,1,3480
2021-01-14,대구,11,10,1,8109
2021-01-14,부산,47,45,2,2320
2021-01-14,서울,127,122,5,22183
2021-01-14,합계,513,484,29,71241
2021-01-13,검역,11,0,11,2579
2021-01-13,제주,2,2,0,492
2021-01-13,경남,16,16,0,1705
2021-01-13,경북,18,16,2,2718
2021-01-13,전남,6,6,0,618
2021-01-13,전북,3,3,0,961
2021-01-13,충남,12,12,0,1878
2021-01-13,충북,18,18,0,1442
2021-01-13,강원,11,11,0,1489
2021-01-13,경기,171,162,9,17605
2021-01-13,세종,2,2,0,161
2021-01-13,울산,10,9,1,854
2021-01-13,대전,3,3,0,937
2021-01-13,광주,31,30,1,1406
2021-01-13,인천,25,24,1,3456
2021-01-13,대구,11,11,0,8098
2021-01-13,부산,40,40,0,2273
2021-01-13,서울,134,131,3,22056
2021-01-13,합계,524,496,28,70728
2021-01-12,검역,3,0,3,2568
2021-01-12,제주,1,1,0,490
2021-01-12,경남,42,42,0,1689
2021-01-12,경북,24,23,1,2701
2021-01-12,전남,0,0,0,612
2021-01-12,전북,8,7,1,958
2021-01-12,충남,5,4,1,1866
2021-01-12,충북,11,11,0,1424
2021-01-12,강원,21,20,1,1478
2021-01-12,경기,201,189,12,17434
2021-01-12,세종,0,0,0,159
2021-01-12,울산,11,11,0,844
2021-01-12,대전,9,9,0,934
2021-01-12,광주,4,3,1,1375
2021-01-12,인천,22,20,2,3431
2021-01-12,대구,13,13,0,8094
2021-01-12,부산,35,35,0,2233
2021-01-12,서울,152,148,4,21922
2021-01-12,합계,562,536,26,70212
2021-01-11,검역,8,0,8,2565
2021-01-11,제주,2,2,0,489
2021-01-11,경남,55,55,0,1647
2021-01-11,경북,8,8,0,2677
2021-01-11,전남,2,2,0,612
2021-01-11,전북,12,11,1,950
2021-01-11,충남,3,1,2,1861
2021-01-11,충북,16,16,0,1413
2021-01-11,강원,7,7,0,1457
2021-01-11,경기,175,163,12,17233
2021-01-11,세종,1,1,0,159
2021-01-11,울산,7,7,0,833
2021-01-11,대전,7,7,0,925
2021-01-11,광주,7,7,0,1371
2021-01-11,인천,21,20,1,3409
2021-01-11,대구,18,17,1,8081
2021-01-11,부산,21,21,0,2198
2021-01-11,서울,167,163,4,21771
2021-01-11,합계,537,508,29,69651
2021-01-10,검역,11,0,11,2557
2021-01-10,제주,2,2,0,487
2021-01-10,경남,13,13,0,1592
2021-01-10,경북,4,4,0,2669
2021-01-10,전남,3,3,0,610
2021-01-10,전북,7,6,1,938
2021-01-10,충남,11,10,1,1858
2021-01-10,충북,10,9,1,1397
2021-01-10,강원,11,10,1,1450
2021-01-10,경기,147,142,5,17058
2021-01-10,세종,0,0,0,158
2021-01-10,울산,14,14,0,826
2021-01-10,대전,1,1,0,918
2021-01-10,광주,24,24,0,1364
2021-01-10,인천,22,18,4,3388
2021-01-10,대구,11,10,1,8063
2021-01-10,부산,19,16,3,2177
2021-01-10,서울,141,137,4,21604
2021-01-10,합계,451,419,32,69114
2021-01-09,검역,14,0,14,2546
2021-01-09,제주,4,4,0,485
2021-01-09,경남,19,19,0,1579
2021-01-09,경북,19,19,0,2665
2021-01-09,전남,4,3,1,607
2021-01-09,전북,6,6,0,931
2021-01-09,충남,30,30,0,1847
2021-01-09,충북,9,8,1,1387
2021-01-09,강원,20,20,0,1439
2021-01-09,경기,193,189,4,16912
2021-01-09,세종,0,0,0,158
2021-01-09,울산,34,34,0,812
2021-01-09,대전,4,4,0,917
2021-01-09,광주,21,18,3,1340
2021-01-09,인천,33,32,1,3366
2021-01-09,대구,34,34,0,8052
2021-01-09,부산,34,32,2,2158
2021-01-09,서울,187,179,8,21463
2021-01-09,합계,665,631,34,68664
2021-01-08,검역,10,0,10,2532
2021-01-08,제주,5,5,0,481
2021-01-08,경남,26,23,3,1560
2021-01-08,경북,21,20,1,2646
2021-01-08,전남,5,5,0,603
2021-01-08,전북,14,13,1,925
2021-01-08,충남,27,26,1,1817
2021-01-08,충북,30,30,0,1378
2021-01-08,강원,6,5,1,1419
2021-01-08,경기,211,195,16,16719
2021-01-08,세종,0,0,0,158
2021-01-08,울산,8,8,0,778
2021-01-08,대전,5,5,0,913
2021-01-08,광주,6,6,0,1319
2021-01-08,인천,49,46,3,3333
2021-01-08,대구,13,12,1,8018
2021-01-08,부산,17,17,0,2124
2021-01-08,서울,188,180,8,21276
2021-01-08,합계,641,596,45,67999
2021-01-07,검역,6,0,6,2522
2021-01-07,제주,6,6,0,476
2021-01-07,경남,22,19,3,1534
2021-01-07,경북,30,28,2,2625
2021-01-07,전남,0,0,0,598
2021-01-07,전북,8,7,1,911
2021-01-07,충남,21,21,0,1790
2021-01-07,충북,10,10,0,1348
2021-01-07,강원,11,11,0,1413
2021-01-07,경기,258,236,22,16508
2021-01-07,세종,0,0,0,158
2021-01-07,울산,10,10,0,770
2021-01-07,대전,8,8,0,908
2021-01-07,광주,21,21,0,1313
2021-01-07,인천,30,30,0,3284
2021-01-07,대구,18,17,1,8005
2021-01-07,부산,24,22,2,2107
2021-01-07,서울,191,186,5,21088
2021-01-07,합계,674,632,42,67358
2021-01-06,검역,14,0,14,2516
2021-01-06,제주,9,9,0,470
2021-01-06,경남,20,20,0,1512
2021-01-06,경북,36,34,2,2595
2021-01-06,전남,1,0,1,598
2021-01-06,전북,2,2,0,903
2021-01-06,충남,20,19,1,1769
2021-01-06,충북,14,14,0,1338
2021-01-06,강원,30,30,0,1402
2021-01-06,경기,303,294,9,16250
2021-01-06,세종,3,3,0,158
2021-01-06,울산,9,9,0,760
2021-01-06,대전,9,9,0,900
2021-01-06,광주,28,28,0,1292
2021-01-06,인천,41,37,4,3254
2021-01-06,대구,10,10,0,7987
2021-01-06,부산,23,23,0,2083
2021-01-06,서울,298,292,6,20899
2021-01-06,합계,870,833,37,66686
2021-01-05,검역,6,0,6,2502
2021-01-05,제주,5,5,0,461
2021-01-05,경남,29,26,3,1492
2021-01-05,경북,28,28,0,2559
2021-01-05,전남,1,1,0,597
2021-01-05,전북,22,22,0,901
2021-01-05,충남,24,23,1,1749
2021-01-05,충북,21,21,0,1324
2021-01-05,강원,16,16,0,1372
2021-01-05,경기,284,269,15,15947
2021-01-05,세종,1,1,0,155
2021-01-05,울산,2,2,0,751
2021-01-05,대전,9,8,1,891
2021-01-05,광주,30,30,0,1264
2021-01-05,인천,38,35,3,3213
2021-01-05,대구,22,21,1,7978
2021-01-05,부산,38,38,0,2060
2021-01-05,서울,264,263,1,20602
2021-01-05,합계,840,809,31,65818
2021-01-04,검역,16,0,16,2497
2021-01-04,제주,8,8,0,456
2021-01-04,경남,21,21,0,1463
2021-01-04,경북,24,24,0,2531
2021-01-04,전남,4,4,0,596
2021-01-04,전북,5,4,1,879
2021-01-04,충남,18,18,0,1725
2021-01-04,충북,32,32,0,1303
2021-01-04,강원,27,27,0,1356
2021-01-04,경기,230,214,16,15663
2021-01-04,세종,0,0,0,154
2021-01-04,울산,4,4,0,749
2021-01-04,대전,8,7,1,882
2021-01-04,광주,23,23,0,1234
2021-01-04,인천,49,48,1,3175
2021-01-04,대구,32,31,1,7956
2021-01-04,부산,15,14,1,2022
2021-01-04,서울,199,193,6,20338
2021-01-04,합계,715,672,43,64979
2021-01-03,검역,11,0,11,2481
2021-01-03,제주,10,9,1,448
2021-01-03,경남,33,33,0,1442
2021-01-03,경북,25,25,0,2507
2021-01-03,전남,3,3,0,592
2021-01-03,전북,13,9,4,874
2021-01-03,충남,23,22,1,1707
2021-01-03,충북,23,23,0,1271
2021-01-03,강원,28,28,0,1329
2021-01-03,경기,268,260,8,15434
2021-01-03,세종,0,0,0,154
2021-01-03,울산,5,5,0,745
2021-01-03,대전,6,6,0,874
2021-01-03,광주,74,74,0,1211
2021-01-03,인천,103,101,2,3126
2021-01-03,대구,29,29,0,7924
2021-01-03,부산,37,34,3,2007
2021-01-03,서울,329,324,5,20138
2021-01-03,합계,1020,985,35,64264
2021-01-02,검역,8,0,8,2470
2021-01-02,제주,4,4,0,438
2021-01-02,경남,12,12,0,1409
2021-01-02,경북,14,14,0,2482
2021-01-02,전남,12,12,0,589
2021-01-02,전북,5,5,0,861
2021-01-02,충남,9,9,0,1684
2021-01-02,충북,27,26,1,1248
2021-01-02,강원,33,33,0,1301
2021-01-02,경기,205,201,4,15166
2021-01-02,세종,1,1,0,154
2021-01-02,울산,7,7,0,740
2021-01-02,대전,8,8,0,868
2021-01-02,광주,26,26,0,1137
2021-01-02,인천,48,48,0,3023
2021-01-02,대구,22,21,1,7895
2021-01-02,부산,19,19,0,1970
2021-01-02,서울,197,195,2,19809
2021-01-02,합계,657,641,16,63244
2021-01-01,검역,14,0,14,2462
2021-01-01,제주,13,12,1,434
2021-01-01,경남,37,35,2,1397
2021-01-01,경북,20,18,2,2468
2021-01-01,전남,11,9,2,577
2021-01-01,전북,11,11,0,856
2021-01-01,충남,7,6,1,1675
2021-01-01,충북,36,34,2,1221
2021-01-01,강원,31,31,0,1268
2021-01-01,경기,227,221,6,14962
2021-01-01,세종,3,3,0,153
2021-01-01,울산,17,17,0,733
2021-01-01,대전,4,4,0,860
2021-01-01,광주,13,13,0,1111
2021-01-01,인천,71,70,1,2975
2021-01-01,대구,29,29,0,7873
2021-01-01,부산,26,26,0,1951
2021-01-01,서울,250,245,5,19613
2021-01-01,합계,824,788,36,62593
2020-12-31,검역,4,0,4,2448
2020-12-31,제주,5,5,0,421
2020-12-31,경남,35,34,1,1360
2020-12-31,경북,24,24,0,2448
2020-12-31,전남,6,6,0,566
2020-12-31,전북,8,8,0,845
2020-12-31,충남,15,15,0,1668
2020-12-31,충북,22,22,0,1185
2020-12-31,강원,30,29,1,1237
2020-12-31,경기,284,271,13,14735
2020-12-31,세종,1,1,0,150
2020-12-31,울산,43,43,0,716
2020-12-31,대전,11,11,0,856
2020-12-31,광주,17,16,1,1098
2020-12-31,인천,65,63,2,2904
2020-12-31,대구,43,43,0,7844
2020-12-31,부산,57,55,2,1925
2020-12-31,서울,358,357,1,19362
2020-12-31,합계,1027,1002,25,61754
